Why does it feel like I'm being watched...?	なんだか人の視線を感じる。	Why does it feel like I'm being watched...?	……何だか視線を感じる。
I glance around the room.	部屋を見回してみる。	I glance around the room.	部屋を見回してみる。
Suddenly, I notice Yuri peering at me from over her book.	突然、ユリが俺を本越しにのぞいてることに気づく。	Suddenly, I notice Yuri peering at me from over her book.	ユリが俺のことを本越しにのぞいているではないか。
But she looks away just as quickly with a flustered look on her face.	でもすぐに慌てた表情で目をそらした。	But she looks away just as quickly with a flustered look on her face.	でも、彼女はすぐに慌てた表情で目をそらした。
I realize that she won't get anywhere like this.	おそらくこのままじゃ何も起きないだろう。	I realize that she won't get anywhere like this.	おそらくこのままじゃ何も起きないだろう。
I've never really seen Yuri approach anyone or start a conversation on her own accord.	彼女から誰かに話しかけたり近づいたりするのを見たことがない。	I've never really seen Yuri approach anyone or start a conversation on her own accord.	なぜなら、彼女から誰かに話しかけたり近づいたりするのを見たことがないからだ。
So, I have no choice but to approach her myself.	俺から話しかけにいくしかないようだ。	So, I have no choice but to approach her myself.	だから、俺から話しかけにいくしかない。
By now, it's a little easier for me to do that.	そういった事も、以前よりはしやすくなったしな。	By now, it's a little easier for me to do that.	そういったことも、前よりはしやすくなったしな。
I stand up from my desk and sit in one next to her own.	自分の机から立ち上がって彼女の隣の席に座る。	I stand up from my desk and sit in one next to her own.	俺は立ち上がり、彼女の隣の席に座る。
「...」	「……」	...	「……」
「I...didn't mean to bother you or anything...」	「邪魔するつもりでは……なかったんです……」	I...didn't mean to bother you or anything...	「邪魔するつもりでは……なかったんです……」
「Relax, you didn't even do anything.」	「心配するな、何も悪いことしてないんだから」	Relax, you didn't even do anything.	「心配するな、何も悪いことしてないんだから」
「But...」	「でも……」	But...	「けど……」
「I could tell that you wanted to be alone with your thoughts...」	「てっきり一人で考え事をしたいのかと……」	I could tell that you wanted to be alone with your thoughts...	「てっきり、一人で考え事をしたいのかと……」
「Alone with my thoughts...?」	「考え事……？」	Alone with my thoughts...?	「考え事……？」
「How were you even able to tell that I was thinking like that?」	「どうして分かったんだ？」	How were you even able to tell that I was thinking like that?	「どうしてわかったんだ？」
「Well...」	「それは……」	Well...	「今度は……」
「It's something that I do a lot...」	「私自身よくそういうことをするんです……」	It's something that I do a lot...	「私自身よくそういうことをするんです……」
「So it wasn't hard for me to spot based on your posture and expression.」	「だからあなたの姿勢や表情から伺えました」	So it wasn't hard for me to spot based on your posture and expression.	「だからあなたの姿勢や表情から窺えました」
「N-Not that I was staring or anything...!」	「あっ、でも別にじっくり見てたわけでは……！」	N-Not that I was staring or anything...!	「あっ、でも別にじっくり見てたわけでは……！」
「I didn't do anything creepy like that...!」	「そんな不気味なことはしてなくて……！」	I didn't do anything creepy like that...!	「そんな不気味なことはしてなくて……！」
「In any case, I guess you were right.」	「どっちにしろ、お前の言ってることは合ってるよ」	In any case, I guess you were right.	「どっちにしろ、お前の言ってることは合ってるよ」
「I'm sorry if I caused you any concern.」	「変に気を使わせてごめんな」	I'm sorry if I caused you any concern.	「変に気を使わせてごめんな」
「Don't apologize...」	「謝らないでください……」	Don't apologize...	「謝らないでください……」
「Your troubles are only the concern of those who willingly share in that concern.」	「私が気を使いたいから、気を使っているんですよ」	Your troubles are only the concern of those who willingly share in that concern.	「私が気を使いたいから使っているんです」
「Of course, there are certainly those who find the most comfort in keeping to themselves...」	「もちろん、悩みは誰にも話さずにいたい人もいるでしょう……」	Of course, there are certainly those who find the most comfort in keeping to themselves...	「もちろん、悩みは誰にも話さずにいたい人もいるでしょう……」
「But if you would prefer to share what's on your mind, then I would be glad to listen.」	「ですが、もし誰かに打ち明けたいのであれば、私はぜひ聞きたいです」	But if you would prefer to share what's on your mind, then I would be glad to listen.	「ですが、もしあなたが誰かに打ち明けたいのであれば、私はぜひ聞きたいです」
「Ah, it's really not that big of a deal...」	「いや、本当そんな大ごとじゃなくてさ……」	Ah, it's really not that big of a deal...	「いや、本当そんな大ごとじゃなくてさ……」
「I was just feeling a bit uneasy about Sayori.」	「ただサヨリのことを考えてたら落ち着かなくて」	I was just feeling a bit uneasy about Sayori.	「ただサヨリのことを考えてたら落ち着かなくて」
「Sayori...?」	「サヨリちゃん……？」	Sayori...?	「サヨリ……？」
「Yeah...she seems a little off today, but when I asked her about it, she didn't want to admit it to me.」	「ああ……今日はちょっと様子がおかしいんだ。でもどうしたのか聞いてみても、話してくれなくて」	Yeah...she seems a little off today, but when I asked her about it, she didn't want to admit it to me.	「ああ……今日はちょっと様子がおかしいんだ。でも、聞いてみても、俺には話してくれなくて」
「So I can't help but wonder if something happened to her.」	「だから何かあったんじゃないかって気がしてならないんだ……」	So I can't help but wonder if something happened to her.	「だから何かあったんじゃないかって……」
「Oh?」	「あら？」	Oh?	「あら」
「That's quite romantic...」	「なんだかロマンチックですね……」	That's quite romantic...	「何だかロマンチックですね……」
「Eh...?」	「え……？」	Eh...?	「え……？」
「S-Sorry!」	「ご、ごめんなさい！」	S-Sorry!	「ご、ごめんなさい！」
「I didn't mean to say something stupid...!」	「変なことを言うつもりはなかったんです！」	I didn't mean to say something stupid...!	「変なことを言うつもりはなかったんです……！」
「It's not that, I just didn't want you to misunderstand.」	「いや、ただ勘違いしてほしくなかっただけだよ」	It's not that, I just didn't want you to misunderstand.	「いや、ただ勘違いしてほしくなかっただけだよ」
「Sayori and I have just been friends for a long time, that's all.」	「サヨリとは長い付き合いだけど友達さ、それだけだよ」	Sayori and I have just been friends for a long time, that's all.	「サヨリとは長い付き合いだけど友達さ、それだけだよ」
「Ah...I see...」	「そ、そうですか……」	Ah...I see...	「そ、そうですか……」
「Then perhaps it is unusual for her to be dismissive to you about her feelings...」	「なら、あなたに気持ちを伝えずそっけなくするのはおかしいかもしれませんね……」	Then perhaps it is unusual for her to be dismissive to you about her feelings...	「なら、あなたに話をしないというのは、おかしいかもしれませんね……」
「Or maybe I'm just reading into it a little too much...」	「ひょっとしたら俺が深読みしすぎてるだけかもな…」	Or maybe I'm just reading into it a little too much...	「ひょっとしたら俺が深読みしすぎてるだけかもな…」
「[player]...」	「[player]さん……」	[player]...	「[player]……」
「The world is full of meaning, often hidden deep beneath plain sight.」	「何事にも意味はあります。ただ見ただけでは分からないこともあるのです」	The world is full of meaning, often hidden deep beneath plain sight.	「何事にも意味はあります。ただ見ただけではわからないこともあるのです」
「And there are many untold mysteries behind every person, no matter how well you may know them.」	「どれだけよく知っていると思う人でも、誰しも秘密はあるものですよ」	And there are many untold mysteries behind every person, no matter how well you may know them.	「どれだけよく知っている人でも、秘密はあるものですよ」
「Ah...」	「ああ……」	Ah...	「あのね……」
「So you think that there might be something behind it after all?」	「じゃあやっぱりユリも何かあるって思うのか？」	So you think that there might be something behind it after all?	「じゃあやっぱりユリも何かあるって思うのか？」
「Mm...」	「うーん…」	Mm...	「うんと……」
「I think that Sayori is a very complex person.」	「サヨリちゃんはとても複雑な方なんだと思います」	I think that Sayori is a very complex person.	「サヨリちゃんはとても複雑な子なんだと思います」
「Her mannerisms on the outside don't always match what may be going on inside her head...」	「言動と考えていることがずれていることがあって……」	Her mannerisms on the outside don't always match what may be going on inside her head...	「言動と考えていることがずれていることがあって……」
「And she may not always know what she wants.」	「自分でも何がしたいのかわかっていないのかもしれません」	And she may not always know what she wants.	「自分でも何がしたいのかわかっていないのかもしれません」
「I noticed her strange behavior today, too...」	「私も今日は何だか様子がおかしいなとは思ってました……」	I noticed her strange behavior today, too...	「私も今日は何だか様子がおかしいなとは思ってました……」
「And I also feel some concern for her.」	「私も多少は心配ですけど……」	And I also feel some concern for her.	「私も少し心配ですけど……」
「But in your case, it looked like she was fully occupying your thoughts, wasn't she?」	「あなたって、サヨリちゃんのことで頭がいっぱいなんですね」	But in your case, it looked like she was fully occupying your thoughts, wasn't she?	「あなたって、サヨリちゃんのことで頭がいっぱいなんですね」
「Well...」	「まあ……」	Well...	「その、つまり……」
「I guess that was the case.」	「そんな感じかな」	I guess that was the case.	「ああ、今はそんな感じかな」
「Sayori...」	「サヨリちゃんって……」	Sayori...	「……サヨリ……」
「She really...means a lot to you, doesn't she?」	「あなたにとって……大切な人ですよね？」	She really...means a lot to you, doesn't she?	「あなたにとって……大切な人ですよね？」
「Ah--I...I guess...」	「ああ……そ、そうかもな」	Ah--I...I guess...	「ああ……そ、そうかもな」
「But you don't need to put it that way!」	「でも別にそんな言い方しなくていいだろ！」	But you don't need to put it that way!	「でも別にそんな言い方しなくていいだろ！」
「We're just good friends, that's all...」	「俺たちは親友なだけだ……」	We're just good friends, that's all...	「俺たちは親友なだけだ……」
「...」	「……」	...	「……」
Yuri suddenly looks deeply into my eyes.	ユリは急に俺の目を見つめてくる。	Yuri suddenly looks deeply into my eyes.	ユリは急に俺の目を見つめてくる。
Her expression is gentle and curious, as if she was searching for something.	その表情は優しくも知りたげで、何かを探しているようだった。	Her expression is gentle and curious, as if she was searching for something.	その表情は優しくも知りたげで、何かを探しているようだった。
Embarrassed, I avert my gaze.	恥ずかしくて、目を逸らす。	Embarrassed, I avert my gaze.	恥ずかしくて、俺は目をそらす。
「Sometimes...」	「時々……」	Sometimes...	「時々……」
「A person's mysteries are untold even to themselves.」	「人の謎はその人自身にも分からないことがあります」	A person's mysteries are untold even to themselves.	「人の謎はその人自身にもわからないことがあります」
「And you, as someone honest and caring...」	「でも正直で思いやりのあるあなたなら……」	And you, as someone honest and caring...	「でも正直で思いやりのあるあなたなら……」
「May uncover feelings you weren't aware were in you.」	「あなたの中にある、あなたが気づいていない感情を見つけることができるかもしれません」	May uncover feelings you weren't aware were in you.	「あなたの中にある、あなたが気づいていない感情を見つけることができるかもしれません」
「T-That is...」	「だ、だから……」	T-That is...	「だ、だから……」
「I think that...」	「私は……」	I think that...	「私は……」
「She would be a very fortunate person...」	「サヨリちゃんは……とても幸運だなって思います」	She would be a very fortunate person...	「サヨリちゃんは……とても幸運だなって思います」
「To have you...feel that way about her.」	「そんな風に想ってくれる人がいるなんて」	To have you...feel that way about her.	「そんな風に想ってくれる人がいるなんて」
「Yuri...」	「ユリ……」	Yuri...	「ユリ……」
「You're giving me too much credit.」	「お前は俺のことを買い被り過ぎてるよ」	You're giving me too much credit.	「俺のこと、買い被り過ぎだよ」
「I'm a pretty simple guy.」	「俺、単純だからさ」	I'm a pretty simple guy.	「俺、単純だからさ」
「So I think I'm pretty good at understanding my own feelings.」	「自分の感情は良く分かってると思ってる」	So I think I'm pretty good at understanding my own feelings.	「自分の感情は良くわかってると思う」
「I'm not nearly as sophisticated as you.」	「俺はユリみたいに立派じゃないんだ」	I'm not nearly as sophisticated as you.	「俺は、ユリみたいに立派じゃないんだ」
「A-Ah...」	「あ、あぁ……」	A-Ah...	「う、うん……」
「That's not...a compliment, is it?」	「それは褒め言葉……でしょうか？」	That's not...a compliment, is it?	「それは褒め言葉……でしょうか？」
「It is what it is.」	「そのままの意味だよ」	It is what it is.	「そのままの意味だよ」
「Anyway, as long as we're here, why don't we do some reading?」	「それはそうと、せっかくここにいるんだから本でも読まないか？」	Anyway, as long as we're here, why don't we do some reading?	「それはそうと、せっかくここにいるんだから本でも読まないか？」
「Well...」	「えっと……」	Well...	「えっと……」
「As long as you're okay with it.」	「あなたが良ければ」	As long as you're okay with it.	「あなたが良ければ」
「Yeah.」	「ああ」	Yeah.	「そうね」
「I should be taking my mind off this whole thing anyway.」	「とにかくこの事は忘れた方がいいだろうしな」	I should be taking my mind off this whole thing anyway.	「とにかくこの事は忘れた方がいいだろうしな」
