I'm really curious to talk to Yuri a little bit more...	この機会にユリともう少し話をしてみたいが……	I'm really curious to talk to Yuri a little bit more...	この機会にユリともう少し話をしてみたいが……
But at the same time, I would feel bad for distracting her from reading.	けど読書の邪魔をしては悪いとも思う。	But at the same time, I would feel bad for distracting her from reading.	けど読書の邪魔をしては悪いとも思う。
I catch a glimpse of the cover of her book.	ユリが読んでる本の表紙をチラッと見てみる。	I catch a glimpse of the cover of her book.	ユリが読んでいる本の表紙をチラッと見てみる。
It looks like the same book that she lent to me...	俺に貸してくれた本と同じ物のようだ。	It looks like the same book that she lent to me...	俺に貸してくれた本と同じもののようだ。
More than that, she seems to be on the first few pages.	それに、まだ最初の数ページしか読んでないようだ。	More than that, she seems to be on the first few pages.	それに、まだ最初の数ページしか読んでないらしい。
「Ah...」	「あっ……」	Ah...	「あのね……」
Crap--	やべっ――	Crap--	やべっ――
I think she noticed me looking at her...	見てたのがバレたか……？	I think she noticed me looking at her...	見てたのがバレたか……？
She sneaks another glance at me, and our eyes meet for a split second.	彼女がまたチラッとこちらを見た一瞬、目が合う。	She sneaks another glance at me, and our eyes meet for a split second.	彼女がまたチラッとこちらを見た一瞬、目が合う。
「...」	「……」	...	「……」
But that only makes her hide her face deeper in her book.	それによってユリは顔をさらに本の方へと隠してしまった。	But that only makes her hide her face deeper in her book.	けれど、ユリは顔を本で覆うように隠してしまった。
「Sorry...」	「悪い……」	Sorry...	「悪い……」
「I was just spacing out...」	「ボーッとしてて……」	I was just spacing out...	「ボーッとしてて……」
I mutter this, sensing I made her uncomfortable.	気まずくさせてしまったと思い、つぶやいた。	I mutter this, sensing I made her uncomfortable.	気まずくさせてしまったと思い、俺はそうつぶやいた。
「Oh...」	「いえ……」	Oh...	「何よ……」
「It's fine...」	「大丈夫です……」	It's fine...	「大丈夫です……」
「If I was focused, then I probably wouldn't have noticed in the first place.」	「私もちゃんと集中して読んでいたら、きっと気づきませんでしたから」	If I was focused, then I probably wouldn't have noticed in the first place.	「私もちゃんと集中して読んでいたら、きっと気づきませんでしたから」
「But I'm just re-reading a bit of this, so...」	「でも軽く読み返してるだけなので……」	But I'm just re-reading a bit of this, so...	「でも軽く読み返してるだけなので……」
「That's the book that you gave me, right?」	「それって俺に貸してくれた本だよな？」	That's the book that you gave me, right?	「それって、俺に貸してくれた本だよな？」
「Mhm.」	「はいっ」	Mhm.	「ええ」
「I wanted to re-read some of it.」	「少し読み直してみたくなりまして」	I wanted to re-read some of it.	「少し読み直してみたくなりまして」
「Not for any particular reason...!」	「と、特に理由はありませんが……！」	Not for any particular reason...!	「と、特に理由はありませんが……！」
「Just curious, how come you have two copies of the same book?」	「気になったんだが、なんで同じ本を二冊持ってたんだ？」	Just curious, how come you have two copies of the same book?	「気になったんだが、なんで同じ本を二冊持ってたんだ？」
「Ah...」	「あっ……」	Ah...	「ああ……」
「Well, when I stopped at the bookstore yesterday--」	「それは、昨日本屋へ寄ったとき――」	Well, when I stopped at the bookstore yesterday--	「それは、昨日本屋へ寄ったとき――」
「Ah, that's not what I meant...」	「そ、そうではなくて……」	Ah, that's not what I meant...	「あ、いや、そうではなくて……」
「I mean--」	「ええと……」	I mean--	「ええと……」
「I...just happened to buy two of them.」	「た……たまたま二冊買ってあったんです」	I...just happened to buy two of them.	「た……たまたま二冊買ってあったんです」
「Ah, I see.」	「ふーん、そっか」	Ah, I see.	「ふーん、そっか」
There's something fairly obvious here that Yuri isn't telling me, but I decide to let it go.	おそらくユリは何かを隠そうとしていたが、あまり気にしないことにした。	There's something fairly obvious here that Yuri isn't telling me, but I decide to let it go.	おそらくユリは何かを隠そうとしていたが、あまり気にしないことにした。
「I'll definitely start reading it soon!」	「近いうちに俺も読み始めるよ！」	I'll definitely start reading it soon!	「近いうちに俺も読み始めるよ！」
「I'm glad to hear...」	「良かったです……」	I'm glad to hear...	「良かったです……」
「Once it starts to pick up, you might have a hard time putting it down.」	「一度読み始めたら、止まらなくなるかもしれませんよ？」	Once it starts to pick up, you might have a hard time putting it down.	「一度読み始めたら、止まらなくなるかもしれませんよ？」
「It's a very engaging and relatable story.」	「とても魅力的で、共感できるお話ですから」	It's a very engaging and relatable story.	「とても魅力的で、共感できるお話ですから」
「Is that so...?」	「そうなのか……」	Is that so...?	「そうなのですね……」
