「Heeeeeeeyyy!!」	「おーはーよーーー！」	Heeeeeeeyyy!!	「おっはよーーー！」
I see an annoying girl running toward me from the distance, waving her arms in the air like she's totally oblivious to any attention she might draw to herself.	遠くから鬱陶しい女の子が、宙に手を振りながら周囲の目をまったく気にしない様子で、こちらに走ってくる。	I see an annoying girl running toward me from the distance, waving her arms in the air like she's totally oblivious to any attention she might draw to herself.	遠くから騒がしい女の子が、周囲の目をまったく気にせず、手を振りながらこっちに走ってくる。
That girl is Sayori, my neighbor and good friend since we were children.	あの子はサヨリといって、近所に住んでいる幼馴染だ。	That girl is Sayori, my neighbor and good friend since we were children.	あの子はサヨリといって、近所に住んでいる幼馴染だ。
You know, the kind of friend you'd never see yourself making today, but it just kind of works out because you've known each other for so long?	今友達にしたいとはとても思わないだろうが、それでもうまくいっているのは幼馴染だからなのか。	You know, the kind of friend you'd never see yourself making today, but it just kind of works out because you've known each other for so long?	友達にしたいタイプではないが、それでもうまくいっているのは幼馴染だからか。
We used to walk to school together on days like this, but starting around high school she would oversleep more and more frequently, and I would get tired of waiting up.	こんな日にはよく一緒に登校していたが、高校生になってから彼女の寝坊が多くなり、俺は待つのがだるくなってきた。	We used to walk to school together on days like this, but starting around high school she would oversleep more and more frequently, and I would get tired of waiting up.	よく一緒に登校していたが、高校生になってから彼女の寝坊が多くなり、待つのがだるくなってきた。
But if she's going to chase after me like this, I almost feel better off running away.	こんな風に追いかけて来るなら、もういっそのこと逃げてしまおうかと思う。	But if she's going to chase after me like this, I almost feel better off running away.	こんな風に追いかけて来られるなら、もういっそのこと逃げてしまおうかと思う。
However, I just sigh and idle in front of the crosswalk and let Sayori catch up to me.	でも俺はやれやれと横断歩道の前でサヨリを待った。	However, I just sigh and idle in front of the crosswalk and let Sayori catch up to me.	でも、俺はため息をついて、横断歩道の前でサヨリを待った。
「Haaahhh...haaahhh...」	「はあ……はぁ……」	Haaahhh...haaahhh...	「はあ……はぁ……」
「I overslept again!」	「また寝坊しちゃった！」	I overslept again!	「また寝坊しちゃった！」
「But I caught you this time!」	「でも今度は追いついたからね！」	But I caught you this time!	「でも、今日は追いついたからね！」
「Maybe, but only because I decided to stop and wait for you.」	「そりゃ俺が立ち止まってお前を待ったからだろ」	Maybe, but only because I decided to stop and wait for you.	「そりゃ、俺が立ち止まってお前を待ったからだろ」
「Eeehhhhh, you say that like you were thinking about ignoring me!」	「えええ、まるでわたしを無視するつもりだった様な言い方じゃん！」	Eeehhhhh, you say that like you were thinking about ignoring me!	「えええ、わたしを無視するつもりだったみたいな言い方じゃん！」
「That's mean, [player]!」	「[player]のいじわる！」	That's mean, [player]!	「[player]のイジワル！」
「Well, if people stare at you for acting weird then I don't want them to think we're a couple or something.」	「そりゃ、変てこなお前を見た周りの人に俺たちがカップルか何かだとは思われたくないし」	Well, if people stare at you for acting weird then I don't want them to think we're a couple or something.	「そりゃ、周りの人にお前みたいなヘンテコちゃんとカップルか何かだとか思われたくないし」
「Fine, fine.」	「はい、はい」	Fine, fine.	「はい、はい」
「But you did wait for me, after all.」	「でも結局、わたしを待っててくれたんでしょ」	But you did wait for me, after all.	「でも結局、わたしを待っててくれたんでしょ？」
「I guess you don't have it in you to be mean even if you want to~」	「いじわるしたくても、できないんだね～」	I guess you don't have it in you to be mean even if you want to~	「イジワルしたくても、できないんだね～」
「Whatever you say, Sayori...」	「何とでも言っとけ、サヨリ」	Whatever you say, Sayori...	「……何とでも言えよ」
「Ehehe~」	「えへへ～」	Ehehe~	「うふふ」
We cross the street together and make our way to school.	俺たちは道路を渡り、学校へ歩みを進める。	We cross the street together and make our way to school.	俺たちは横断歩道を渡り、学校へと歩みを進める。
As we draw near, the streets become increasingly speckled with other students making their daily commute.	学校に近づくと、通学路には他の生徒の姿が徐々に増えていく。	As we draw near, the streets become increasingly speckled with other students making their daily commute.	学校に近づくにつれ、通学路には他の生徒の姿が徐々に増えていく。
「By the way, [player]...」	「ところでさ、[player]……」	By the way, [player]...	「ところでさ、[player]……」
「Have you decided on a club to join yet?」	「まだ入る部活は決めてないの？」	Have you decided on a club to join yet?	「入る部活って、まだ決めてないの？」
「A club?」	「部活？」	A club?	「部活？」
「I told you already, I'm really not interested in joining any clubs.」	「マジで部活には興味ないって前から言っていたはずだが」	I told you already, I'm really not interested in joining any clubs.	「前に言っただろ、マジで部活には興味ない」
「I haven't been looking, either.」	「それに探してもいないよ」	I haven't been looking, either.	「探してもいないよ」
「Eh? That's not true!」	「えぇぇぇ、そんなぁ！」	Eh? That's not true!	「えぇぇぇ、そんなぁ！」
「You told me you would join a club this year!」	「今年は部活入るって言ってたじゃん！」	You told me you would join a club this year!	「今年は部活入るって言ってたじゃん！」
「Did I...?」	「え、言ったか？」	Did I...?	「え、言ったか？」
I'm sure it's possible that I did, in one of our many conversations where I dismissively go along with whatever she's going on about.	いつものように彼女の話に合わせて適当に返事していた時にでも言ってしまった可能性は十分にある。	I'm sure it's possible that I did, in one of our many conversations where I dismissively go along with whatever she's going on about.	いつものように、彼女の話に適当に相槌を打っていた時に言ってしまった可能性は十分にある。
Sayori likes to worry a little too much about me, when I'm perfectly content just getting by on the average while spending my free time on games and anime.	暇な時間は大抵アニメかゲームをやって、平穏な生活が送れればもうそれで満足なのに、彼女はそれを心配しすぎる節がある。	Sayori likes to worry a little too much about me, when I'm perfectly content just getting by on the average while spending my free time on games and anime.	暇な時間はアニメを見るかゲームをして、平穏な生活が送れればそれで俺は満足なのに、サヨリはそれを妙に心配しているのだ。
「Uh-huh!」	「ああ、もう！」	Uh-huh!	「ああ、もう！」
「I was talking about how I'm worried that you won't learn how to socialize or have any skills before college.」	「わたしは[player]が大学に行く前に社会性もスキルも身につかないんじゃないかって心配だっていってるの！」	I was talking about how I'm worried that you won't learn how to socialize or have any skills before college.	「わたしは[player]が大学へ行く前に社会性もスキルも身につかないんじゃないか心配だって言ってるの！」
「Your happiness is really important to me, you know!」	「[player]の幸せはわたしにとっても大事なんだから！」	Your happiness is really important to me, you know!	「[player]の幸せはわたしにとっても大事なんだから！」
「And I know you're happy now, but I'd die at the thought of you becoming a NEET in a few years because you're not used to the real world!」	「今は楽しくやっているみたいだけど、数年後世間に馴染めずニートになっている姿を想像するだけでわたしは死んじゃいそう！」	And I know you're happy now, but I'd die at the thought of you becoming a NEET in a few years because you're not used to the real world!	「今は楽しくやってるみたいだけど、数年後世間に馴染めずニートになってる姿を想像するだけで、わたし、死んじゃいそう！」
「You trust me, right?」	「ちゃんと言うこと聞いてくれる？」	You trust me, right?	「ちゃんと言うこと聞いてくれる？」
「Don't make me keep worrying about you...」	「わたしを心配させないでよ……」	Don't make me keep worrying about you...	「心配させないでよ……」
「Alright, alright...」	「分かった、分かった……」	Alright, alright...	「わかった、わかった……」
「I'll look at a few clubs if it makes you happy.」	「そんなに言うなら、いくつか部活を見てみるよ」	I'll look at a few clubs if it makes you happy.	「そんなに言うなら、いくつか部活を見てみるよ」
「No promises, though.」	「約束は出来ないけどな」	No promises, though.	「約束はできないけど」
「Will you at least promise me you'll try a little?」	「少しは努力するって約束してくれる？」	Will you at least promise me you'll try a little?	「じゃあ、少しは努力するって約束してくれる？」
「Yeah, I guess I'll promise you that.」	「まあ、それくらいなら」	Yeah, I guess I'll promise you that.	「まあ、それくらいなら」
「Yaay~!」	「やった～！」	Yaay~!	「やった～！」
Why do I let myself get lectured by such a carefree girl?	どうして俺はこんな呑気な奴に説教されることを許しているんだ？	Why do I let myself get lectured by such a carefree girl?	どうして俺は、こんなノンキなやつに説教されているのだろうか？
More than that, I'm surprised I even let myself relent to her.	それどころか、こうやって従ってしまう事に驚きだ。	More than that, I'm surprised I even let myself relent to her.	それどころか驚くべきことに、こうやって従ってしまっている。
I guess seeing her worry so much about me makes me want to ease her mind at least a little bit - even if she does exaggerate everything inside of her head.	俺のことを過剰に心配している様子をみていると、少しくらいは安心させてやりたくなるのだろう――ちょっと脳内のことを大げさにとらえる癖があっても。	I guess seeing her worry so much about me makes me want to ease her mind at least a little bit - even if she does exaggerate everything inside of her head.	過剰に心配してくれてるのを見ているうちに、少しくらい安心させてやりたくなるのだろうか――脳内で物事を大げさにする癖がサヨリにあるとしても。
The school day is as ordinary as ever, and it's over before I know it.	普段通りの学校生活は、いつの間にか終わっていた。	The school day is as ordinary as ever, and it's over before I know it.	普段通りの授業が、気づかぬうちに終わっていく。
After I pack up my things, I stare blankly at the wall, looking for an ounce of motivation.	荷物をまとめた後、自分の中のやる気を探して壁をぼんやりと眺める。	After I pack up my things, I stare blankly at the wall, looking for an ounce of motivation.	帰り支度を終え、壁をぼんやりと眺めながら、自分のやる気を探ってみる。
「Clubs...」	「部活か……」	Clubs...	「部活か……」
Sayori wants me to check out some clubs.	サヨリは俺にいくつか見学して欲しいようだった。	Sayori wants me to check out some clubs.	サヨリは俺に部活見学をしてほしいようだった。
I guess I have no choice but to start with the anime club...	とりあえずアニメ研究会から始めてみるしかないかな……	I guess I have no choice but to start with the anime club...	とりあえず、アニメ研究会から始めてみるしかないかな……。
「Hellooo?」	「やっほー」	Hellooo?	「やっほー！」
「Sayori...?」	「サヨリ……？」	Sayori...?	「サヨリ……？」
Sayori must have come into the classroom while I was spacing out.	俺がぼんやりしている間にサヨリが教室に入って来たようだ。	Sayori must have come into the classroom while I was spacing out.	ぼんやりしているうちに、サヨリが教室にやってきた。
I look around and realize that I'm the only one left in the classroom.	俺は周りを見て教室で残った最後の一人だということに気付いた。	I look around and realize that I'm the only one left in the classroom.	どうやら、みんな教室を出てしまって、俺が最後の一人らしい。
「I thought I'd catch you coming out of the classroom, but I saw you just sitting here and spacing out, so I came in.」	「教室から出るところで声をかけようと思ってたけど、座ってぼーっとしていたから入ってきちゃった」	I thought I'd catch you coming out of the classroom, but I saw you just sitting here and spacing out, so I came in.	「教室の外で声をかけようと待ってたんだけど、座ってぼーっとしたままだったから、入ってきちゃった」
「Honestly, you're even worse than me sometimes... I'm impressed!」	「正直たまにわたしよりもだらけてるよね……感心！」	Honestly, you're even worse than me sometimes... I'm impressed!	「正直わたしよりダラけてる時あるよね……さっすが！」
「You don't need to wait up for me if it's going to make you late to your own club.」	「部活に遅れそうなら待たなくてもいいよ」	You don't need to wait up for me if it's going to make you late to your own club.	「待ってなくていいよ、お前が部活に遅れるだろ？」
「Well, I thought you might need some encouragement, so I thought, you know...」	「ちょっとした励ましが必要かなと思って、それに……」	Well, I thought you might need some encouragement, so I thought, you know...	「背中を押してあげなきゃなと思って！ それに……」
「Know what?」	「それに……？」	Know what?	「それに……？」
「Well, that you could come to my club!」	「わたしの部に来てもいいんだよ！」	Well, that you could come to my club!	「わたしの部に来てもいいんだよ！」
「Sayori...」	「お前なあ」	Sayori...	「……サヨリ……」
「Yeah??」	「うん？」	Yeah??	「何？」
「...There is no way I'm going to your club.」	「……俺がそこに行くはずがないだろ」	...There is no way I'm going to your club.	「……俺が、お前の部に、行くはずないだろ？」
「Eeeehhhhh?! Meanie!」	「えええええええ！？ ケチ！」	Eeeehhhhh?! Meanie!	「えええええええ！？何それヤダ、ケチ！」
Sayori is vice president of the Literature Club.	サヨリは文芸部の副部長をやっている。	Sayori is vice president of the Literature Club.	サヨリは、新設された文芸部の副部長だ。
Not that I was ever aware that she had any interest in literature.	文学に関心を持っていただなどかつて気づいたこともない。	Not that I was ever aware that she had any interest in literature.	まさか、彼女が文学に関心があったとは、俺も知らなかった。
In fact, I'm 99% sure she only did it because she thought it would be fun to help start a new club.	実際、部の新設の手伝いをするのが楽しそうだからというだけで参加したのだと99％確信している。	In fact, I'm 99% sure she only did it because she thought it would be fun to help start a new club.	部を新設するって楽しそう！というだけで参加したのだと99%思っているが。
Since she was the first one to show interest after the one who proposed the club, she inherited the title "Vice President".	部を提案した人の初めての賛同者だったから、『副部長』の座に就いたみたいだ。	Since she was the first one to show interest after the one who proposed the club, she inherited the title "Vice President".	サヨリは、発起人に最初に賛同したことで『副部長』の座に就けたらしい。
That said, my interest in literature is guaranteed to be even less.	とはいえ、文学になんて彼女より興味ないこと請け合いだ。	That said, my interest in literature is guaranteed to be even less.	とはいえ、そんな彼女以上に、俺は文学になんて一切興味がないのだ。
「Yeah. I'm going to the anime club.」	「そうか、じゃあアニメ部に行ってくる」	Yeah. I'm going to the anime club.	「ケチで悪かったな。じゃあ、アニメ研究会に行ってくるよ」
「C'mon, please?」	「お願いだから来てくれない？」	C'mon, please?	「どうしても、来てくれないの？」
「Why do you care so much, anyway?」	「どうしてそこまで必死なんだよ？」	Why do you care so much, anyway?	「何でそんな必死なんだよ？」
「Well...」	「ええと……」	Well...	「今度は……」
「I kind of told the club yesterday I would bring in a new member...」	「だって昨日みんなに新入部員連れてくるって言っちゃったし……」	I kind of told the club yesterday I would bring in a new member...	「だって昨日、みんなに新入部員連れてくるって言っちゃってさ……」
「And Natsuki made cupcakes and everything...」	「それにナツキちゃんがカップケーキとか色々作ってきてるし……」	And Natsuki made cupcakes and everything...	「ナツキちゃんなんか、カップケーキとかいろいろつくってきてるし……」
「Ehehe...」	「えへへ……」	Ehehe...	「だから……えへへ……」
「Don't make promises you can't keep!」	「守れない約束なんてするなよ！」	Don't make promises you can't keep!	「守れない約束なんてするなよ！」
I can't tell if Sayori is really that much of an airhead, or if she's so cunning as to have planned all of this out.	サヨリが本当にアホの子なのかそれとも全部計算づくなのかは分からない。	I can't tell if Sayori is really that much of an airhead, or if she's so cunning as to have planned all of this out.	サヨリが本当にアホの子なのか、それとも全部計算づくなのかはわからない。
I let out a long sigh.	俺は大きくため息をついた。	I let out a long sigh.	俺は大きくため息をついた。
「Fine... I'll stop by for a cupcake, okay?」	「分かった……カップケーキに免じて寄るとするよ」	Fine... I'll stop by for a cupcake, okay?	「わかった……カップケーキに免じて、寄ってやろう」
「Yes! Let's go~!」	「やった！ よし行こう～！」	Yes! Let's go~!	「やった～！ よし、行こっ！」
And thus, today marks the day I sold my soul for a cupcake.	というわけで、今日は俺がカップケーキに魂を売った日だと記録されるだろう。	And thus, today marks the day I sold my soul for a cupcake.	というわけで、本日この日は、俺がカップケーキに魂を売った日として歴史に刻まれるだろう。
I dejectedly follow Sayori across the school and upstairs - a section of the school I rarely visit, being generally used for third-year classes and activities.	やれやれと思いながらサヨリの後について校舎をわたり階段を上っていく。着いたのは、学校の中でも普段は３年生の授業や活動で使用され、自分は滅多に行くことがない場所だった。	I dejectedly follow Sayori across the school and upstairs - a section of the school I rarely visit.	やれやれと思いながら、サヨリの後について校舎をわたり、階段を上がっていく――着いたのは、学校の中でも滅多に足を踏み入れない場所だった。
Sayori, full of energy, swings open the classroom door.	サヨリは元気いっぱいに勢いよく教室のドアを開けた。	Sayori, full of energy, swings open the classroom door.	サヨリは元気いっぱい、勢いよく教室のドアを開けた。
「Everyone! The new member is here~!」	「みんな！ 新入部員がきたよ～！」	Everyone! The new member is here~!	「みんな！！ 新入部員がきたよ～！！！」
「I told you, don't call me a 'new member--'」	「おい、俺を新入部員って呼ぶなって――」	I told you, don't call me a 'new member--'	「おい待て、入るとは言ってな――」
Eh? I glance around the room.	えっ？ 教室をひと目見回した。	Eh? I glance around the room.	俺は、教室をひと目見回した。
「Welcome to the Literature Club. It's a pleasure meeting you.」	「ようこそ文芸部へ、お会いできて嬉しいです」	Welcome to the Literature Club. It's a pleasure meeting you.	「ようこそ文芸部へ、お会いできてうれしいです」
「Sayori always says nice things about you.」	「サヨリちゃんからあなたのことはよく聞いています」	Sayori always says nice things about you.	「サヨリちゃんからあなたのことはよく聞いています」
「Seriously? You brought a boy?」	「正気？ 男子連れて来たわけ？」	Seriously? You brought a boy?	「マジ？ 男子連れて来たわけ？」
「Way to kill the atmosphere.」	「雰囲気ぶち壊しじゃない」	Way to kill the atmosphere.	「雰囲気ぶち壊しじゃない」
「Ah, [player]! What a nice surprise!」	「あ、[player]君！ よく来てくれたわね！」	Ah, [player]! What a nice surprise!	「あ、[player]君！よく来てくれたわね！」
「Welcome to the club!」	「ようこそ！ 文芸部へ！」	Welcome to the club!	「ようこそ！ 文芸部へ！」
「...」	「……」	...	「……」
All words escape me in this situation.	つい言葉を失ってしまった。	All words escape me in this situation.	つい言葉を失ってしまった。
This club...	この部活は……	This club...	「この部活は……」
<i>...is full of incredibly cute girls!!</i>	<i>最高にかわいい子だらけじゃないか！</i>	<i>...is full of incredibly cute girls!!</i>	<i>……めちゃくちゃかわいい子だらけじゃないか！</i>
「What are you looking at?」	「あんたどこを見てんのよ？」	What are you looking at?	「ちょっとアンタ！ どこ見てんのよ？」
「If you want to say something, say it.」	「言いたいことがあるなら言いなさいよ」	If you want to say something, say it.	「言いたいことがあるなら言いなさいよ」
「S-Sorry...」	「ご、ごめん」	S-Sorry...	「ご、ごめん」
「Natsuki...」	「ナツキちゃん……」	Natsuki...	「ナツキ……」
「Hmph.」	「ふん」	Hmph.	「ふん」
The girl with the sour attitude, whose name is apparently Natsuki, is one I don't recognize.	なんだか当たりの強いこの女の子は初めて見る子だ。ナツキというらしい。	The girl with the sour attitude, whose name is apparently Natsuki, is one I don't recognize.	この、何だか当たりの強い女の子は初めて見る子だ。ナツキというらしい。
Her small figure makes me think she's probably a first-year.	小さい容姿からして１年生だろうか。	Her small figure makes her look like a first-year student.	小柄な背丈から、1年生のように見える。
She is also the one who made cupcakes, according to Sayori.	サヨリの話だとカップケーキを作ったのは彼女のようだ。	She is also the one who made cupcakes, according to Sayori.	サヨリによると、カップケーキをつくったのは彼女だそうだ。
「You can just ignore her when she gets moody~」	「不機嫌な時は放っておいていいよ～」	You can just ignore her when she gets moody~	「あの子、機嫌悪いときがあるけど、放っておいていいよ～」
Sayori says that quietly into my ear, then turns back toward the other girls.	サヨリはそう俺に耳打ちし、みんなの方へ向き直した。	Sayori says that quietly into my ear, then turns back toward the other girls.	サヨリはそう俺に耳打ちし、みんなの方へ顔を戻した。
「Anyway! This is Natsuki, always full of energy.」	「とにかくこの子がナツキちゃん、いつも元気いっぱいだよ！」	Anyway! This is Natsuki, always full of energy.	「とにかくこの子がナツキちゃん、いつも元気いっぱいだよ！」
「And this is Yuri, the smartest in the club!」	「それでこっちがユリちゃん、この部で一番の秀才なの！」	And this is Yuri, the smartest in the club!	「それでこっちがユリちゃん、この部で一番の秀才なの！」
「D-Don't say things like that...」	「そ、そんな風に言わないでください……」	D-Don't say things like that...	「そ、そんな風に言わないでください……」
Yuri, who appears comparably more mature and timid, seems to have a hard time keeping up with people like Sayori and Natsuki.	他の子に比べやや大人っぽく、また臆病そうなこの子はユリというらしい。サヨリやナツキのようなタイプと一緒にやっていくのに苦労していそうだ。	Yuri, who appears comparably more mature and timid, seems to have a hard time keeping up with people like Sayori and Natsuki.	他の子に比べて大人っぽく、臆病そうにも見えるこの子はユリというらしい。サヨリやナツキのようなタイプと一緒にやっていくのは、さぞ大変だろう。
「Ah... Well, it's nice to meet both of you.」	「ええと、二人ともよろしく」	Ah... Well, it's nice to meet both of you.	「ええと、二人ともよろしく」
「And it sounds like you already know Monika, is that right?」	「それと聞いた感じ、モニカとはもう知り合いなの？」	And it sounds like you already know Monika, is that right?	「それと、聞いた感じ、モニカとはもう知り合いなの？」
「That's right.」	「ええ」	That's right.	「ああ」
「It's great to see you again, [player].」	「また会えて嬉しいわ、[player]君」	It's great to see you again, [player].	「また会えてうれしいわ、[player]君」
Monika smiles sweetly.	モニカは優しくほほ笑む。	Monika smiles sweetly.	モニカは優しく微笑む。
We do know each other - well, we rarely talked, but we were in the same class last year.	俺たちは去年同じクラスだったから、お互いのことは知っている。とはいえ滅多に話さないが。	We do know each other - well, we rarely talked, but we were in the same class last year.	去年同じクラスだったから、お互いのことは知っている。とはいえ滅多に話さなかったが。
Monika was probably the most popular girl in class - smart, beautiful, athletic.	モニカは容姿端麗・文武両道。おそらくクラスで一番人気だった女の子だ。	Monika was probably the most popular girl in class - smart, beautiful, athletic.	モニカは容姿端麗・文武両道。おそらくクラスで一番人気だった女の子だ。
Basically, completely out of my league.	要するに、高嶺の花だ。	Basically, completely out of my league.	要するに、高嶺の花だ。
So, having her smile at me so genuinely feels a little...	だから彼女に微笑まれて、なんというか……	So, having her smile at me so genuinely feels a little...	だから彼女に微笑まれると、何と言うか……
「Y-You too, Monika.」	「こ、こっちこそ」	Y-You too, Monika.	「こ、こっちこそ」
「Come sit down, [player]! We made room for you at the table, so you can sit next to me or Monika.」	「こっちに座って、[player]！ スペース作ったから、わたしかモニカちゃんの隣が空いてるよ」	Come sit down, [player]! We made room for you at the table, so you can sit next to me or Monika.	「さ、こっちに座って、[player]！わたしかモニカちゃんの隣が空いてるよ！」
「I'll get the cupcakes~」	「カップケーキ持ってくるね～」	I'll get the cupcakes~	「カップケーキ持ってくるね～」
「Hey! I made them, I'll get them!」	「ちょっと！ わたしが作ったんだから、わたしが持ってくるわよ」	Hey! I made them, I'll get them!	「ちょっと！ アタシがつくったんだから、アタシが持っていくの！」
「Sorry, I got a little too excited~」	「ごめんごめん、ちょっと楽しみすぎて～」	Sorry, I got a little too excited~	「ごめんごめん、ちょっと楽しみすぎて～」
「Then, how about I make some tea as well?」	「それでは、私はお茶を淹れますね」	Then, how about I make some tea as well?	「それでは、私はお茶を淹れますね」
The girls have a few desks arranged to form a table.	机が並べられて作られたテーブルがある。	The girls have a few desks arranged to form a table.	机を並べてつくったテーブルがある。
As Sayori mentioned, it's been widened so that there is one space next to Monika and one space next to Sayori.	サヨリの言った通り、モニカとサヨリの隣が一つずつ空いている。	As Sayori mentioned, it's been widened so that there is one space next to Monika and one space next to Sayori.	サヨリの言った通り、モニカとサヨリの隣が一つずつ空いている。
Natsuki and Yuri walk over to the corner of the room, where Natsuki grabs a wrapped tray and Yuri opens the closet.	ナツキとユリは教室の隅に向かった。ナツキはホイルで包まれたトレイを取り、ユリはクローゼットを開けている。	Natsuki and Yuri walk over to the corner of the room, where Natsuki grabs a wrapped tray and Yuri opens the closet.	ナツキとユリは教室の隅に向かった。ナツキはホイルで包まれたトレイを取り、ユリは物置を開けている。
Still feeling awkward, I take a seat next to Sayori.	未だに気まずさを感じつつも、俺はサヨリの隣の席に座る。	Still feeling awkward, I take a seat next to Sayori.	居心地の悪さを感じつつも、俺はサヨリの隣の席に座る。
Natsuki proudly marches back to the table, tray in hand.	ナツキはトレイを持って、誇らしげにテーブルへやって来た。	Natsuki proudly marches back to the table, tray in hand.	トレイを持ったナツキが、誇らしげにテーブルへやって来た。
「Okaaay, are you ready?」	「準備はいいかしら？」	Okaaay, are you ready?	「準備はいいかしら？」
「...Ta-daa!」	「じゃじゃーん！」	...Ta-daa!	「じゃじゃーん！」
「Uwooooah!」	「うっわああぁぁ～～っ！！」	Uwooooah!	「うっわああぁぁ～～っ！！」
Natsuki lifts the foil off the tray to reveal a dozen white, fluffy cupcakes decorated to look like little cats.	ナツキがアルミホイルをめくると白くてかわいい、子猫のようなカップケーキが12個顔を見せた。	Natsuki lifts the foil off the tray to reveal a dozen white, fluffy cupcakes decorated to look like little cats.	ナツキがアルミホイルをめくると、白くてかわいい子猫のような12個のカップケーキが顔を見せた。
The whiskers are drawn with icing, and little pieces of chocolate were used to make ears.	猫のひげはアイシングで、耳は少量のチョコで作られているようだ。	The whiskers are drawn with icing, and little pieces of chocolate were used to make ears.	猫のひげはアイシングで、耳は少量のチョコでつくられているようだ。
「So cuuuute~!」	「すっごくかわいいぃ～！」	So cuuuute~!	「すっごくかわいいぃ～！」
「I had no idea you were so good at baking, Natsuki!」	「ナツキがお菓子作りが得意だったなんてね」	I had no idea you were so good at baking, Natsuki!	「ナツキがお菓子づくりが得意だったなんてね」
「Ehehe. Well, you know.」	「えへへ。まあ、ね」	Ehehe. Well, you know.	「えへへ。まあ、ね」
「Just hurry and take one!」	「早く食べてよね！」	Just hurry and take one!	「早く食べてよね！」
Sayori grabs one first, then Monika. I follow.	サヨリが一つ手に取り、モニカと俺も続いた。	Sayori grabs one first, then Monika. I follow.	サヨリが一つ手に取り、モニカと俺も続いた。
「It's delicious!」	「おいしい！」	It's delicious!	「おいしい！」
Sayori talks with her mouth full and has already managed to get icing on her face.	サヨリはカップケーキで口をいっぱいにして話し、顔にアイシングがついてしまっている。	Sayori talks with her mouth full and has already managed to get icing on her face.	サヨリはカップケーキを頬張って言い、顔にはアイシングがついてしまっている。
I turn the cupcake around in my fingers, looking for the best angle to take a bite.	俺は食べやすい向きを探してカップケーキを回す。	I turn the cupcake around in my fingers, looking for the best angle to take a bite.	俺は食べやすい向きを探してカップケーキを回す。
Natsuki is quiet.	ナツキは黙りこくっている。	Natsuki is quiet.	ナツキは黙りこくっている。
I can't help but notice her sneaking glances in my direction.	俺に対する彼女の無言の視線を気にせずにはいられない。	I can't help but notice her sneaking glances in my direction.	俺に対する彼女の無言の視線を気にせずにはいられない。
Is she waiting for me to take a bite?	俺が食べるのを待っているのか？	Is she waiting for me to take a bite?	俺が食べるのを待っているのか？
I finally bite down.	ついにカップケーキを口に運ぶ。	I finally bite down.	ついにカップケーキを口に運ぶ。
The icing is sweet and full of flavor - I wonder if she made it herself.	アイシングは甘く風味豊かで――これ、本当にナツキが作ったのか？	The icing is sweet and full of flavor - I wonder if she made it herself.	アイシングは甘く風味豊かで――これ、本当にナツキがつくったのか？
「This is really good.」	「これ、すごく美味いぞ」	This is really good.	「これ、すごく美味い」
「Thank you, Natsuki.」	「ありがとう、ナツキ」	Thank you, Natsuki.	「ありがとう、ナツキ」
「W-Why are you thanking me? It's not like I...!」	「な、なに言ってるの？ 別に……！」	W-Why are you thanking me? It's not like I...!	「な、なに言ってるの？ べ、別に……！」
<i>(Haven't I heard this somewhere before...?)</i>	<i>（どこかで聞いたことあるような……？）</i>	<i>(Haven't I heard this somewhere before...?)</i>	<i>（何か聞いたことあるぞ……？）</i>
「...Made them for you or anything.」	「……別にあんたのために作ったわけじゃないし」	...Made them for you or anything.	「……別にアンタのためにつくったんじゃないんだからね……」
「Eh? I thought you technically did. Sayori said--」	「え？ 実際そうなんじゃないのか？ サヨリもそう言ってたし――」	Eh? I thought you technically did. Sayori said--	「え？ でも、実際俺のためだろ？ サヨリもそう言ってたし――」
「Well, maybe!」	「まあ、そうね！」	Well, maybe!	「まあ、そうね！」
「But not for, y-you know, <i>you!</i> Dummy...」	「で、でも、あくまで新入部員のためで、<i>あんた個人</i>のためじゃないんだからね！ バカ……」	But not for, y-you know, <i>you!</i> Dummy...	「で、でも、あくまで新入部員のためで、別に<i>アンタ</i>のためじゃないんだからね！ バカ……」
「Alright, alright...」	「分かった、分かった……」	Alright, alright...	「わかった、わかった……」
I give up on Natsuki's weird logic and dismiss the conversation.	ナツキの変な論理には降参して、会話を終わらせる。	I give up on Natsuki's weird logic and dismiss the conversation.	ナツキの変な論理に降参して、会話を終わらせる。
Yuri returns to the table, carrying a tea set.	ユリはティーセットを抱えテーブルに戻ってくる。	Yuri returns to the table, carrying a tea set.	ユリはティーセットを抱えてテーブルに戻ってくる。
She carefully places a teacup in front of each of us before setting down the teapot next to the cupcake tray.	彼女は慎重にみんなの前にティーカップを置き、カップケーキのあるトレイの隣にティーポットを置いた。	She carefully places a teacup in front of each of us before setting down the teapot next to the cupcake tray.	彼女は慎重にみんなの前にティーカップを置き、カップケーキのあるトレイの隣にティーポットを置いた。
「You keep a whole tea set in this classroom?」	「教室にティーセットを置いてるのか？」	You keep a whole tea set in this classroom?	「教室にティーセットを置いてるのか？」
「Don't worry, the teachers gave us permission.」	「大丈夫です、ちゃんと先生方の許可はいただいてますから」	Don't worry, the teachers gave us permission.	「大丈夫です、ちゃんと先生方の許可はいただいてますから」
「After all, doesn't a hot cup of tea help you enjoy a good book?」	「それに、温かいお茶があると読書も捗るでしょう？」	After all, doesn't a hot cup of tea help you enjoy a good book?	「それに、温かいお茶があると読書も捗るでしょう？」
「Ah... I-I guess...」	「ああ……そ、そうだな……」	Ah... I-I guess...	「ああ……そ、そうだな……」
「Ehehe, don't let yourself get intimidated, Yuri's just trying to impress you.」	「えへへ、そんなに怯えなくてもいいわ。ユリはただあなたの関心を引こうとしてるだけよ」	Ehehe, don't let yourself get intimidated, Yuri's just trying to impress you.	「ふふふ、そんなにびくびくしなくてもいいわ。ユリはただあなたの関心を引こうとしてるだけよ」
「Eh?! T-That's not...」	「え、そ、そんなこと……」	Eh?! T-That's not...	「え、そ、そんなこと……」
Insulted, Yuri looks away.	からかわれて、ユリはそっぽを向く。	Insulted, Yuri looks away.	からかわれて、ユリはそっぽを向く。
「I meant that, you know...」	「私はただ、その……」	I meant that, you know...	「私はただ、その……」
「I believe you.」	「分かってるよ」	I believe you.	「わかってるよ」
「Well, tea and reading might not be a pastime for me, but I at least enjoy tea.」	「まあ、お茶を飲みながらの読書は馴染みのない習慣だが、お茶は普通に好きだから」	Well, tea and reading might not be a pastime for me, but I at least enjoy tea.	「まあ、お茶を飲みながら本なんて読まないけどさ、お茶は普通に好きだから」
「I'm glad...」	「良かった……」	I'm glad...	「うれしいです……」
Yuri faintly smiles to herself in relief.	ユリはほっとしたようにかすかに微笑んでいる。	Yuri faintly smiles to herself in relief.	ユリはほっとしたように小さく微笑んだ。
Monika raises an eyebrow, then smiles at me.	モニカは眉を上げ、そして微笑んできた。	Monika raises an eyebrow, then smiles at me.	モニカは眉を上げ、そして笑顔を向けた。
「So, what made you consider the Literature Club?」	「そういえば、あなたはどうして文芸部に入ろうと思ったの？」	So, what made you consider the Literature Club?	「そういえば、あなたはどうして文芸部に入ろうと思ったの？」
「Um...」	「えぇと……」	Um...	「その……」
I was afraid of this question.	俺はこの質問が来るのを恐れていた。	I was afraid of this question.	俺はこの質問が来るのを恐れていた。
Something tells me I shouldn't tell Monika that I was practically dragged here by Sayori.	実はサヨリに引きずられて来た、だなんて言うべきではない気がする。	Something tells me I shouldn't tell Monika that I was practically dragged here by Sayori.	実はサヨリに引っ張って来られたんだ、だなんて言うべきではない気がする。
「Well, I haven't joined any clubs yet, and Sayori seemed really happy here, so...」	「まあ、まだ部活に入ってないし、それにサヨリがこの部活ですごく楽しそうにしてるみたいだから……」	Well, I haven't joined any clubs yet, and Sayori seemed really happy here, so...	「まあ、まだ部活に入ってないし、それにサヨリがこの部活ですごく楽しそうにしてるみたいだから……」
「That's okay! Don't be embarrassed!」	「それでいいのよ！ 恥ずかしがらないで！」	That's okay! Don't be embarrassed!	「それでいいのよ。 恥ずかしがらないで！」
「We'll make sure you feel right at home, okay?」	「あなたが居心地がいいって感じられるようにしてみせるから」	We'll make sure you feel right at home, okay?	「あなたが居心地がいいなって感じられるようにしてみせるから」
「As president of the Literature Club, it's my duty to make the club fun and exciting for everyone!」	「文芸部の部長として、部室を楽しくてワクワクするような場所にするのは私の義務だからね！」	As president of the Literature Club, it's my duty to make the club fun and exciting for everyone!	「部室を楽しくワクワクする場所にするのは、文芸部部長としての義務だからね！」
「Monika, I'm surprised.」	「モニカ、驚いたよ」	Monika, I'm surprised.	「でも、驚いたよ」
「How come you decided to start your own club?」	「どうして自分の部を立ち上げようと思ったんだ？」	How come you decided to start your own club?	「どうして自分で部を立ち上げようと思ったんだ？」
「You could probably be a board member for any of the major clubs.」	「モニカならどんなメジャーな部でも幹部になれただろうに」	You could probably be a board member for any of the major clubs.	「モニカならどんなメジャーな部でも幹部になれただろうに」
「Weren't you a leader of the debate club last year?」	「去年はディベート部の部長じゃなかったっけ？」	Weren't you a leader of the debate club last year?	「去年はディベート部の部長じゃなかったっけ？」
「Ahaha, well, you know...」	「あはは、まあ、そうだったんだけど……」	Ahaha, well, you know...	「ふふ、まあ、そうだったんだけど……」
「To be honest, I can't stand all of the politics around the major clubs.」	「正直に言うと、大きな部の部内政治にもううんざりだったの」	To be honest, I can't stand all of the politics around the major clubs.	「正直に言うと、大きな部の部内政治にもううんざりしてね」
「It feels like nothing but arguing about the budget and publicity and how to prepare for events...」	「予算か宣伝かイベントのことしか話していない気がしてね」	It feels like nothing but arguing about the budget and publicity and how to prepare for events...	「予算か宣伝かイベントのことしか話さないの」
「I'd much rather take something I personally enjoy and make something special out of it.」	「そんなことをしてるより、自分が好きなものを通して特別な何かを作りたかったの」	I'd much rather take something I personally enjoy and make something special out of it.	「そんなことより、自分が好きなものを通して特別な何かをつくりたくて」
「And if it encourages others to get into literature, then I'm fulfilling that dream!」	「それで誰かを文学の道に引き込めたなら、本望よ」	And if it encourages others to get into literature, then I'm fulfilling that dream!	「それで誰かを文芸の道に引き込めたなら、本望よ」
「Monika really is a great leader!」	「モニカちゃんは最高のリーダーだよ！」	Monika really is a great leader!	「モニカちゃんは、最高のリーダーだよ！」
Yuri also nods in agreement.	ユリも同意して頷いている。	Yuri also nods in agreement.	ユリも同意してうなずいている。
「Then I'm surprised there aren't more people in the club yet.」	「それにしても部員が少ないことに驚いたよ」	Then I'm surprised there aren't more people in the club yet.	「それにしても、部員が少ないことに驚いたよ」
「It must be hard to start a new club.」	「新しい部活を始めるのは大変だったろうな」	It must be hard to start a new club.	「新しい部活を始めるのは大変だったろうな」
「You could put it that way.」	「そうかもしれないわね」	You could put it that way.	「そうかもしれないわね」
「Not many people are very interested in putting out all the effort to start something brand new...」	「新しいことを始めることに興味がある人が多いわけではないから……」	Not many people are very interested in putting out all the effort to start something brand new...	「新しいことを始めるのに興味がある人が多いわけではないから……」
「Especially when it's something that doesn't grab your attention, like literature.」	「文学みたいに興味を惹かれないものだと、特にね」	Especially when it's something that doesn't grab your attention, like literature.	「文芸みたいに興味を引かれないものだと、特にね」
「You have to work hard to convince people that you're both fun and worthwhile.」	「みんなに楽しくて価値のあるものだと思わせないといけないわけで」	You have to work hard to convince people that you're both fun and worthwhile.	「みんなに楽しくて価値のあるものだと思わせないといけないから」
「But it makes school events, like the festival, that much more important.」	「そうなると文化祭のようなイベントは更に重要になってくるわね」	But it makes school events, like the festival, that much more important.	「そうなると、文化祭のようなイベントはより重要になってくるわ」
「I'm confident that we can all really grow this club before we graduate!」	「私は卒業するまでにはこの部をみんなでもっと大きくできる自信があるわ」	I'm confident that we can all really grow this club before we graduate!	「私が卒業するまでに、この部をみんなでもっと大きくするの」
「Right, everyone?」	「でしょ、みんな？」	Right, everyone?	「でしょ、みんな？」
「Yeah!」	「うんっ！」	Yeah!	「いいね！」
「We'll do our best.」	「最善を尽くします」	We'll do our best.	「最善を尽くします」
「You know it!」	「当たり前でしょ」	You know it!	「当たり前でしょ」
Everyone enthusiastically agrees.	みんながみんな熱意を持って同意する。	Everyone enthusiastically agrees.	みんながみんな熱意を持って同意する。
Such different girls, all interested in the same goal...	こんなにも違う女の子たちが、みんな一つの目標を目指しているとは……	Such different girls, all interested in the same goal...	こんなにタイプの異なる女の子たちが、一つの目標を目指しているとは……
Monika must have worked really hard just to find these three.	この３人を集めるのにモニカは相当苦労しただろう。	Monika must have worked really hard just to find these three.	この３人を集めるのだって、モニカは相当苦労しただろう。
Maybe that's why they were all so delighted by the idea of a new member joining.	だからこんなに新入部員を大いに歓迎しているのだろうか。	Maybe that's why they were all so delighted by the idea of a new member joining.	だからこんなに新入部員を歓迎しているのだろうか。
Though I still don't really know if I can keep up with their level of enthusiasm about literature...	ただ俺が彼女らと同じレベルで文学に熱意を持てるかどうかまだ分からない。	Though I still don't really know if I can keep up with their level of enthusiasm about literature...	でも、俺がみんなと同じレベルで文芸部に熱意を持てるだろうか？
「So, [player], what kinds of things do you like to read?」	「あの、[player]さんは普段どんな本を読まれるんですか？」	So, [player], what kinds of things do you like to read?	「あの、[player]さんは普段どんな本を読まれるんですか？」
「Well... Ah...」	「ええ、ああ……」	Well... Ah...	「ええ、ああ……」
Considering how little I've read these past few years, I don't really have a good way of answering that.	ここ数年ほとんど本を読んでいないので、なんと答えれば良いのか思いつかない。	Considering how little I've read these past few years, I don't really have a good way of answering that.	ここ数年まともに本を読んでいないので、何て答えればいいのかさえ思いつかない。
「...Manga...」	「……マンガ……とか」	...Manga...	「……マンガ……とか」
I mutter quietly to myself, half-joking.	冗談交じりに呟く。	I mutter quietly to myself, half-joking.	冗談交じりに呟く。
Natsuki's head suddenly perks up.	ナツキの頭がピクンと反応した。	Natsuki's head suddenly perks up.	ナツキがピクンと反応した。
It looks like she wants to say something, but she keeps quiet.	何か言いたげだが、黙っている。	It looks like she wants to say something, but she keeps quiet.	何か言いたげだが、黙っている。
「N-Not much of a reader, I guess...」	「あ、あまり読書家ではないのですね……」	N-Not much of a reader, I guess...	「あ、あまり読書家ではないのですね……」
「...Well, that can change...」	「……今後の変化の余地はある……」	...Well, that can change...	「……まあ、変化の余地はあるし……」
What am I saying?	俺は何を言っているんだろう。	What am I saying?	俺は何を言っているんだろう。
I spoke without thinking after seeing Yuri's sad smile.	ユリが悲しそうに笑ってたから考えなしに言ってしまった。	I spoke without thinking after seeing Yuri's sad smile.	ユリが悲しそうに笑っていたから考えなしに言ってしまった。
「Anyway, what about you, Yuri?」	「それより、ユリはどんな本を読むんだ？」	Anyway, what about you, Yuri?	「それよりさ、ユリはどんな本を読むんだ？」
「Well, let's see...」	「ええとですね……」	Well, let's see...	「そうですね……」
Yuri traces the rim of her teacup with her finger.	ユリは指先でティーカップのふちをなぞる。	Yuri traces the rim of her teacup with her finger.	ユリは指先でティーカップのふちをなぞる。
「My favorites are usually novels that build deep and complex fantasy worlds.」	「私は重厚で複雑な世界観を持ったファンタジーが好きなんです」	My favorites are usually novels that build deep and complex fantasy worlds.	「私は重厚で複雑な世界観を持ったファンタジーが好きなんです」
「The level of creativity and craftsmanship behind them is amazing to me.」	「その世界観を支える創造性や職人芸の凄さといったら、目を見張るものがあるんですよ」	The level of creativity and craftsmanship behind them is amazing to me.	「その世界観を支える創造性や職人芸のすごさといったら、目を見張るものがあるんですよ」
「And telling a good story in such a foreign world is equally impressive.」	「そのような異世界で語られる素敵なストーリーもまた、とても感動的なんです」	And telling a good story in such a foreign world is equally impressive.	「そのような異世界で語られるストーリーもまた、とても感動的なんです」
Yuri goes on, clearly passionate about her reading.	ユリは読書について、とても情熱的に語り続けた。	Yuri goes on, clearly passionate about her reading.	ユリは読書について、とても情熱的に語り続けた。
She seemed so reserved and timid since the moment I walked in, but it's obvious by the way her eyes light up that she finds her comfort in the world of books, not people.	俺が入室した瞬間から控えめでおどおどした様子だった彼女の目が急にぱっと明るくなったことから察するに、彼女は人より本の世界に安らぎを見出すのだろう。	She seemed so reserved and timid since the moment I walked in, but it's obvious by the way her eyes light up that she finds her comfort in the world of books, not people.	俺が入室した瞬間から控えめでおどおどした様子だった彼女の目が、急にぱっと明るくなった。彼女は、人より本の世界に安らぎを見出すらしい。
「But you know, I like a lot of things.」	「でもね、他にも様々なものが好きですよ」	But you know, I like a lot of things.	「でも、他にも好きなものはたくさんありますよ」
「Stories with deep psychological elements usually immerse me as well.」	「奥深い心理的要素を含む物語には思わず夢中になってしまいますね」	Stories with deep psychological elements usually immerse me as well.	「奥深い心理描写がつづられた物語には、思わず夢中になってしまいます」
「Isn't it amazing how a writer can so deliberately take advantage of your own lack of imagination to completely throw you for a loop?」	「作家が読者の想像力不足を逆手に取って驚かせにくるなんて凄いですよね？」	Isn't it amazing how a writer can so deliberately take advantage of your own lack of imagination to completely throw you for a loop?	「作家が読者の想像力不足を逆手に取って驚かせにくるなんて、すごいですよね？」
「Anyway, I've been reading a lot of horror lately...」	「でも最近よく読んでるのはホラーなんです……」	Anyway, I've been reading a lot of horror lately...	「ああ、でも最近よく読んでるのはホラーなんです……」
「Ah, I read a horror book once...」	「ああ、ホラーなら俺も一度読んだことがあるな」	Ah, I read a horror book once...	「ああ、ホラーなら俺も一度読んだことがあるよ」
I desperately grasp something I can relate to at the minimal level.	俺は低レベルな自分が乗っかれる話題を必死になってつかむ。	I desperately grasp something I can relate to at the minimal level.	低レベルな自分が乗っかれる話題を必死になってつかもうとする。
At this rate, Yuri might as well be having a conversation with a rock.	こんな調子じゃ、ユリは石とでも会話しておいたほうがマシだ。	At this rate, Yuri might as well be having a conversation with a rock.	こんなんじゃ、ユリは石とでも話している方がマシかもしれない。
「Really? I wouldn't have expected that, Yuri.」	「本当に？ ユリがホラー好きだなんて意外だわ」	Really? I wouldn't have expected that, Yuri.	「本当に？ ユリがホラー好きだなんて意外だわ」
「For someone as gentle as you...」	「こんな穏やかな人がホラーを読むとはねえ……」	For someone as gentle as you...	「こんな穏やかな人がホラーを読むとはねえ……」
「I guess you could say that.」	「そうかもしれませんね」	I guess you could say that.	「そうかもしれませんね」
「But if a story makes me think, or takes me to another world, then I really can't put it down.」	「でも作品に考えさせられたり、異世界に連れて行かれたりすると、本当に止まらなくなってしまいます」	But if a story makes me think, or takes me to another world, then I really can't put it down.	「でも、考えさせられたり、異世界に連れて行かれたりする作品は、読みだすと本当に止まらなくなってしまいます」
「Surreal horror is often very successful at changing the way you look at the world, if only for a brief moment.」	「シュールレアリスムホラーなんて、少しの間だけかもしれませんが、世界の見え方が変わってしまうことだってありますからね」	Surreal horror is often very successful at changing the way you look at the world, if only for a brief moment.	「シュールレアリスムホラーなんて、少しの間だけかもしれませんが、世界の見え方が変わってしまうんですよ」
「Ugh, I hate horror...」	「うう……わたしホラーは苦手……」	Ugh, I hate horror...	「うう……。アタシ、ホラーは苦手……」
「Oh? Why's that?」	「あら、どうしてですか？」	Oh? Why's that?	「あら、どうしてですか？」
「Well, I just...」	「だって、わたし……」	Well, I just...	「だって、アタシ……」
Natsuki's eyes dart over to me for a split second.	ナツキの目が一瞬こちらに向けられた。	Natsuki's eyes dart over to me for a split second.	ナツキの目が一瞬こちらに向けられた。
「Never mind.」	「なんでもない」	Never mind.	「何でもない」
「That's right, you usually like to write about cute things, don't you, Natsuki?」	「確かに、ナツキはかわいいことを書くのが好きだものね。そうでしょ？」	That's right, you usually like to write about cute things, don't you, Natsuki?	「確かに、ナツキはかわいいことを書くのが好きだものね。そうでしょ？」
「W-What?」	「は、はあ？」	W-What?	「は、はあ？」
「What gives you that idea?」	「どうしてそう思うのよ！？」	What gives you that idea?	「何それ、そ、そんなわけないでしょ！？」
「You left a piece of scrap paper behind last club meeting.」	「前の部活の時、ナツキが下書きの紙を置き忘れてて」	You left a piece of scrap paper behind last club meeting.	「前回の部活の時、ナツキが下書きの紙を置き忘れてて」
「It looked like you were working on a poem called--」	「どうやら詩を書いてたみたいね。タイトルは――」	It looked like you were working on a poem called--	「どうやら詩を書いてたみたいね。タイトルは――」
「Don't say it out loud!!」	「読むなー！！」	Don't say it out loud!!	「言うなー！！」
「And give that back!」	「それとその紙返して！」	And give that back!	「あと、その紙返して！」
「Fine, fine~」	「はいはい～」	Fine, fine~	「はいは～い」
「Ehehe, your cupcakes, your poems...」	「えへへ、ナツキちゃんのカップケーキにナツキちゃんの詩……」	Ehehe, your cupcakes, your poems...	「えへへ、カップケーキに、詩……」
「Everything you do is just as cute as you are~」	「ナツキちゃんはやることまでぜんぶかわいいなあ～」	Everything you do is just as cute as you are~	「ナツキちゃんってば、ホント全部かわいいなあ～」
Sayori sidles up behind Natsuki and puts her hands on her shoulders.	サヨリはナツキの後ろにサッと移動して、ナツキの肩に両手を置いた。	Sayori sidles up behind Natsuki and puts her hands on her shoulders.	サヨリはナツキの後ろにサッと移動して、ナツキの肩に両手を置いた。
「<i>I'm not cute!!</i>」	「<i>かわいくない！！</i>」	<i>I'm not cute!!</i>	「<i>アタシ、かわいくなんかないし！</i>」
「Natsuki, you write your own poems?」	「ナツキって詩を書くのか？」	Natsuki, you write your own poems?	「詩を書くのか？」
「Eh? Well, I guess sometimes.」	「え？ まあ、たまにね」	Eh? Well, I guess sometimes.	「え？ まあ、たまにね」
「Why do you care?」	「なんか問題ある？」	Why do you care?	「何よ、なんか問題ある？」
「I think that's impressive.」	「いやあ、凄いなあって」	I think that's impressive.	「いや、スゴいなあって」
「Why don't you share them sometime?」	「他の人に見せたりしないのか？」	Why don't you share them sometime?	「人に見せたりしないのか？」
「N-No!」	「い、嫌よ！」	N-No!	「し、しないわよ！」
Natsuki averts her eyes.	ナツキは目を逸らした。	Natsuki averts her eyes.	ナツキは目をそらした。
「You wouldn't...like them...」	「そんな……気に入られるようなものでもないし……」	You wouldn't...like them...	「そんな……気に入られるようなものでもないし……」
「Ah...not a very confident writer yet?」	「ああ……まだあまり自信はない感じか」	Ah...not a very confident writer yet?	「ああ……まだあんまり自信はない感じか」
「I understand how Natsuki feels.」	「ナツキちゃんの感じていること、分かります」	I understand how Natsuki feels.	「ナツキちゃんの感じていること、わかります」
「Sharing that level of writing takes more than just confidence.」	「その手の文章を見せるのって、自信以上のものが必要なんですよ」	Sharing that level of writing takes more than just confidence.	「その手の文章を見せるのって、自信以上のものが必要なんですよ」
「The truest form of writing is writing to oneself.」	「自分に向けられた書きものこそが、真の書きものだから」	The truest form of writing is writing to oneself.	「自分に向けられた書きものこそが、真の書きものだから」
「You must be willing to open up to your readers, exposing your vulnerabilities and showing even the deepest reaches of your heart.」	「そういったものを見せる時は、読者に対して心を開いて、自分の弱さを晒し、自分の心の最も深いところすら見せるつもりでいなければいけないのですよ」	You must be willing to open up to your readers, exposing your vulnerabilities and showing even the deepest reaches of your heart.	「そういったものを見せる時は、読者に対して心を開いて、自分の弱さを晒し、心の最も深いところすら見せるつもりでいなければいけないのですよ」
「Do you have writing experience too, Yuri?」	「ユリも執筆の経験があるの？」	Do you have writing experience too, Yuri?	「ユリも執筆の経験があるの？」
「Maybe if you share some of your work, you can set an example and help Natsuki feel comfortable enough to share hers.」	「きっとユリが自分の作品を見せれば、いい見本になって、ナツキが自分のを見せる時に気が楽になるんじゃないかしら？」	Maybe if you share some of your work, you can set an example and help Natsuki feel comfortable enough to share hers.	「ユリが自分の作品を見せれば、いい見本になって、ナツキが自分のを見せる時に気が楽になるんじゃないかしら？」
「...」	「……」	...	「……」
「I guess it's the same for Yuri...」	「どうやらユリもナツキと同じみたいだな」	I guess it's the same for Yuri...	「どうやらユリもナツキと同じみたいだな」
「Aww... I wanted to read everyone's poems...」	「あうー……みんなの詩、読みたかったなあ……」	Aww... I wanted to read everyone's poems...	「あうー……みんなの詩、読みたかったなあ……」
We all sit in silence for a moment.	みんな少しの間黙り込んだ。	We all sit in silence for a moment.	しばしの沈黙。
「Okay!」	「オッケー！」	Okay!	「そうだ！」
「I have an idea, everyone~」	「みんな、一つ考えがあるわ！」	I have an idea, everyone~	「みんな、良い考えがあるわ！」
「...?」	「……？」	...?	「……？」
Natsuki and Yuri look quizzically at Monika.	ナツキとユリはいぶかしげにモニカを見た。	Natsuki and Yuri look quizzically at Monika.	ナツキとユリはいぶかしげにモニカを見た。
「Let's all go home and write a poem of our own!」	「家に帰って、自分の詩を書きましょう！」	Let's all go home and write a poem of our own!	「課題として、詩を書きましょう！」
「Then, next time we meet, we'll all share them with each other.」	「そして、次に会う時に、みんなお互いに見せ合いっこしましょう」	Then, next time we meet, we'll all share them with each other.	「そして次に会う時、お互いに見せ合いっこするの」
「That way, everyone is even!」	「そうすれば、みんな平等でしょ？」	That way, everyone is even!	「そしたら、みんな平等でしょ？」
「U-Um...」	「う、うーん……」	U-Um...	「その……」
「...」	「……」	...	「……」
「Yeaaah! Let's do it!」	「いえーーい！ やってみようよ！」	Yeaaah! Let's do it!	「いえーーい！ やってみようよ！」
「Plus, now that we have a new member, I think it will help us all get a little more comfortable with each other, and strengthen the bond of the club.」	「それと、新入部員も入ったことだし、お互いをもっとよく知ったり、絆を深めたりする良い機会になると思うわ」	Plus, now that we have a new member, I think it will help us all get a little more comfortable with each other, and strengthen the bond of the club.	「それに新入部員も入ったことだし、お互いをもっとよく知ったり、絆を深めたりする良い機会になると思うわ」
「Isn't that right, [player]?」	「そうでしょ、[player]君？」	Isn't that right, [player]?	「そうでしょ、[player]君？」
Monika smiles warmly at me once again.	モニカはまた暖かく微笑んだ。	Monika smiles warmly at me once again.	モニカはまた優しく微笑んだ。
「Hold on...there's still one problem.」	「ちょっと待ってくれ……一つ問題がある」	Hold on...there's still one problem.	「ちょっと待ってくれ……一つ問題がある」
「Eh? What's that?」	「え？ なにかしら？」	Eh? What's that?	「え？ 何かしら？」
Now that we're back to the original topic of me joining the club, I bluntly come forth with what's been on my mind the entire time.	やっと俺が入部する話に戻ってきたところで、ずっと思っていた事をぶっきらぼうに口にする。	Now that we're back to the original topic of me joining the club, I bluntly come forth with what's been on my mind the entire time.	やっと俺が入部する話に戻ってきたところで、はっきりと口にする。
「I never said I would join this club!」	「俺、入部するなんて一言も言ってないぞ！」	I never said I would join this club!	「俺、入部するなんて一言も言ってないぞ！」
「Sayori may have convinced me to stop by, but I never made any decision.」	「サヨリに説得されて寄っただけで、まだ何も決めてない」	Sayori may have convinced me to stop by, but I never made any decision.	「俺は、サヨリに説得されてここに寄っただけで、まだ何も決めてない」
「I still have other clubs to look at, and...um...」	「まだ見学したい部活もあるし、あと……えっと……」	I still have other clubs to look at, and...um...	「まだ見学したい部活もあるし、それにだな、……その……」
I lose my train of thought.	話そうとしていたことが飛んでしまった。	I lose my train of thought.	話そうとしていたことが飛んでしまった。
All four girls stare back at me with dejected eyes.	４人の女の子が失望の眼差しでこっちを見ている。	All four girls stare back at me with dejected eyes.	４人の女の子が、失望の眼差しで俺を見つめるのだ。
「B-But...」	「で、でも……」	B-But...	「そ、そっか……」
「I'm sorry, I thought...」	「ごめんなさい、てっきり……」	I'm sorry, I thought...	「ごめんなさい、てっきり……」
「「ふん」」	「ふん」	Hmph.	「ふん」
「[player]...」	「[player]……」	[player]...	「[player]……」
「Y-You all...」	「み、みんな……」	Y-You all...	「み、みんな……」
I...I'm defenseless against these girls.	俺は……俺はこの子たちには無力だ。	I...I'm defenseless against these girls.	こんな表情のこの子たちを前にして……俺は……どうしたらいい？
How am I supposed to make a clear-headed decision when it's like this?	こんな状況で俺が冷静な判断を下せると思うか？	How am I supposed to make a clear-headed decision when it's like this?	こんな状況で物事を冷静に判断できるわけがない。
That is, if writing poems is the price I need to pay in order to spend every day with these beautiful girls...	要するに、この子たちと毎日を過ごすために詩を書くことが必要だと言うなら……	That is, if writing poems is the price I need to pay in order to spend every day with these beautiful girls...	詩を書けば。ただそれだけで、こんなかわいい子たちと日々を過ごせるのならば……
「...Right.」	「……そうだな」	...Right.	「……それにだ、そう」
「Okay, I've decided, then.」	「よし、決めたよ」	Okay, I've decided, then.	「そう、決めたんだ」
「I'll join the Literature Club.」	「俺は文芸部に入部する！」	I'll join the Literature Club.	「俺は、文芸部に入部する！」
One by one, the girls' eyes light up.	一人ずつ、彼女たちの目が輝く。	One by one, the girls' eyes light up.	彼女たちの目が一斉に輝く。
「Yesss! I'm so happyyy~」	「やったああ！ すっごく嬉しい！」	Yesss! I'm so happyyy~	「やったああ！ すっごくうれしい！」
Sayori wraps her arms around me, jumping up and down.	サヨリは俺に腕を回し、ぴょんぴょん飛び跳ねる。	Sayori wraps her arms around me, jumping up and down.	サヨリは俺に腕を回し、ぴょんぴょん飛び跳ねる。
「H-Hey--」	「お、おい――」	H-Hey--	「お、おい――」
「You really did scare me for a moment...」	「本当にびっくりしたんですよ……？」	You really did scare me for a moment...	「本当にびっくりしたんですよ……？」
「If you really just came for the cupcakes, I would be super pissed.」	「本当にカップケーキのためだけに来てたら、超怒ってたんだからね」	If you really just came for the cupcakes, I would be super pissed.	「カップケーキのためだけに来てたんだったら、ブッ飛ばしてたんだからね」
「Then that makes it official!」	「さあ、これで正式ね！」	Then that makes it official!	「じゃあ、これで正式入部ね！」
「Welcome to the Literature Club!」	「ようこそ、文芸部へ！」	Welcome to the Literature Club!	「ようこそ、文芸部へ！」
「Ah...thanks, I guess.」	「あー、うん……ありがとう」	Ah...thanks, I guess.	「あー、うん……ありがとう」
「Okay, everyone!」	「よし、みんな！」	Okay, everyone!	「よし、みんな！」
「I think with that, we can officially end today's meeting on a good note.」	「これにて今日の部活は終了ね。お疲れさま」	I think with that, we can officially end today's meeting on a good note.	「これにて今日の部活は終了。おつかれさま！」
「Everyone remember tonight's assignment:」	「みんな今日の宿題を忘れないでね」	Everyone remember tonight's assignment:	「さっきの課題、忘れないでね」
「Write a poem to bring to the next meeting, so we can all share!」	「次回の部活で披露できるように、詩を書いて持ってくること！」	Write a poem to bring to the next meeting, so we can all share!	「次回の部活で披露できるように、詩を書いて持ってくること！」
Monika looks over at me once more.	モニカはもう一度こちらに視線を向けた。	Monika looks over at me once more.	モニカはもう一度こちらに視線を向けた。
「[player], I look forward to seeing how you express yourself.」	「[player]君が自分をどう表現するのか、楽しみにしてるわ」	[player], I look forward to seeing how you express yourself.	「[player]君が自分をどう表現するのか、楽しみにしてるわ」
「Ehehe~」	「えへへ～」	Ehehe~	「うふふ」
「Y-Yeah...」	「あ、ああ」	Y-Yeah...	「あ、ああ、うん」
Can I really impress the class star Monika with my mediocre writing skills?	俺なんかの三流の文章力で、クラスのスターだったモニカに良い印象を与えることなんてできるのだろうか？	Can I really impress the class star Monika with my mediocre writing skills?	俺なんかの三流の文章力で、クラスのスターだったモニカに良い印象を与えられるだろうか？
I already feel the anxiety welling up inside me.	俺はすでに不安が湧き上がってくるのを感じていた。	I already feel the anxiety welling up inside me.	早くも不安が押し寄せてくる。
Meanwhile, the girls continue to chit-chat as Yuri and Natsuki clean up their food.	一方で、女子たちはおしゃべりを続けていた。ユリとナツキは食べ物を片付けている。	Meanwhile, the girls continue to chit-chat as Yuri and Natsuki clean up their food.	一方、女子たちはおしゃべりを続けていた。ユリとナツキは食べ物を片付けている。
「Hey, [player], since we're already here, do you want to walk home together?」	「ねえ、[player]、どうせ今一緒なんだし、一緒に帰らない？」	Hey, [player], since we're already here, do you want to walk home together?	「ねえ、[player]、せっかくだしさ、一緒に帰らない？」
That's right - Sayori and I never walk home together anymore because she always stayed after school for clubs.	そうだ――サヨリはいつも部活で学校に残っていたので、サヨリと俺が一緒に帰ることはもうなかった。	That's right - Sayori and I never walk home together anymore because she always stayed after school for clubs.	そうだ――サヨリはいつも部活で学校に残っていたので、最近は一緒に帰ることがなかった。
「Sure, might as well.」	「ああ、そうするか」	Sure, might as well.	「ああ、そうするか」
「Yaay~」	「やった～」	Yaay~	「やった～！」
With that, the two of us depart the clubroom and make our way home.	という訳で、俺とサヨリは部室を出て、一緒に帰ることにした。	With that, the two of us depart the clubroom and make our way home.	というわけで、俺とサヨリは教室を出て、一緒に帰ることにした。
The whole way, my mind wanders back and forth between the four girls:	道中、俺は何度も４人の女の子のことを思い浮かべる。	The whole way, my mind wanders back and forth between the four girls:	帰り道、俺は何度も４人の女の子のことを思い浮かべる。
Sayori,	サヨリ、	Sayori,	サヨリ、
Natsuki,	ナツキ、	Natsuki,	ナツキ、
Yuri,	ユリ、	Yuri,	ユリ、
and, of course, Monika.	そしてもちろん、モニカ。	and, of course, Monika.	そしてもちろん、モニカ。
Will I really be happy spending every day after school in a literature club?	俺は本当に放課後を文芸部で過ごして幸せになれるのだろうか？	Will I really be happy spending every day after school in a literature club?	文芸部生活を通じて、俺は幸せになれるだろうか？
Perhaps I'll have the chance to grow closer to one of these girls...	ひょっとすると誰か一人と親密な関係になれるチャンスが訪れるかもしれない……	Perhaps I'll have the chance to grow closer to one of these girls...	ひょっとして、誰かと親密な関係になれるチャンスが訪れるかも……
Alright!	よし！	Alright!	「了解！」
I'll just need to make the most of my circumstances, and I'm sure good fortune will find me.	この状況をうまく利用して、必ずや幸運を手にしてみせる。	I'll just need to make the most of my circumstances, and I'm sure good fortune will find me.	この状況をうまく利用して、必ずや幸運を手にしてみせる。
And I guess that starts with writing a poem tonight...	その一歩は今夜俺が詩を書くことから始まるのだろう……	And I guess that starts with writing a poem tonight...	その一歩は、今夜俺が詩を書くことから始まるのだろう……
「...」	「……」	...	「……」
「...」	「……」	...	「……」
「W-What...」	「な、なに？」	W-What...	「な、なに？」
「...」	「……」	...	「……」
「This...」	「これは……」	This...	「これは……」
「What is this...?」	「これは何なの……？」	What is this...?	「これは何なの……？」
「Oh no...」	「そんな……」	Oh no...	「どうして……」
「No...」	「だめ……」	No...	「いいえ……」
「This can't be it.」	「これだけじゃない……」	This can't be it.	「おかしいよ……」
「This can't be all there is.」	「これだけのはずがない……」	This can't be all there is.	「こんなはずない……」
「What is this?」	「これは何？」	What is this?	「これは何？」
「What am I?」	「私は何？」	What am I?	「わたしは何？」
「Make it stop!」	「止めて！」	Make it stop!	「止めて！」
「PLEASE MAKE IT STOP!」	「お願いだから止めて！！」	PLEASE MAKE IT STOP!	「お願いだから止めて！！」
