「You'll always be my dearest friend.」	「お前はずっと、俺の大切な親友だ」	You'll always be my dearest friend.	「お前はずっと、俺の大切な親友だ」
「What you need most is for things to be like they've always been.」	「お前に必要なことは、全部今まで通りのままであることだ」	What you need most is for things to be like they've always been.	「お前に必要なのは、何もかもが今まで通りのままであることなんだ」
「Monika told me the truth...」	「モニカは正しかったんだ……」	Monika told me the truth...	「モニカは正しかったんだ……」
「She told me how much happier you seemed after I joined the club.」	「俺が入部してから、お前がどんなに楽しそうに部活で過ごすようになったか教えてくれた」	She told me how much happier you seemed after I joined the club.	「俺が入部してから、お前がどんなに楽しそうに部活で過ごすようになったか教えてくれた」
「I know you're struggling with some really difficult feelings right now.」	「今は難しい気持ちを抱えて苦しんでるのは分かる」	I know you're struggling with some really difficult feelings right now.	「今、難しい気持ちを抱えて苦しんでるのはわかる」
「But...」	「だがな……」	But...	「けど……」
「Please trust me that I know what's best...and what will make you happy in the end.」	「俺を信じてくれ。何がお前にとって最善で……どうすればお前が幸せになるか分かってるから」	Please trust me that I know what's best...and what will make you happy in the end.	「俺を信じてくれ。何がお前にとって最善で……どうすればお前が幸せになるかわかってるから」
「I promise I'll help get things back to the way they were.」	「何もかも元通りにするって約束する」	I promise I'll help get things back to the way they were.	「何もかも、前と同じようにするって約束する」
「I...」	「わ……」	I...	「アタシは……」
「I...see...」	「わか……った……」	I...see...	「わか……った……」
Sayori forces a smile through an incredibly pained expression.	サヨリは微笑んでいるが、信じられないほど痛々しい微笑みだった。	Sayori forces a smile through an incredibly pained expression.	サヨリは傷ついた顔を無理やり微笑みに変える。
「Ahaha...」	「あはは……」	Ahaha...	「そうだな……」
「Is this what it feels like...to get stabbed in the chest?」	「胸をグサッと刺されるのって……こういう気持ちなのかな？」	Is this what it feels like...to get stabbed in the chest?	「胸をグサッと刺されるのって……こういう気持ちなのかな？」
「I should write a poem about this...」	「これで詩が書けそう……」	I should write a poem about this...	「これで詩が書けそう……」
「Sayori--」	「サヨリ――」	Sayori--	「サヨリ……」
「It's okay.」	「大丈夫だよ」	It's okay.	「いいんだよ」
「This is just my punishment...remember?」	「ただの罰だから……覚えてる？」	This is just my punishment...remember?	「ただの罰だから……覚えてる？」
「For being so selfish...」	「わがままの」	For being so selfish...	「わがままの」
「So please...」	「だからお願い……」	So please...	「だからお願い……」
「Please don't worry about these stupid feelings.」	「お願いだからこんなバカみたいな気持ちの心配をしないで」	Please don't worry about these stupid feelings.	「お願いだからこんなバカみたいな気持ちの心配をしないで」
「I know you're right.」	「[player]が正しいよ」	I know you're right.	「[player]が正しいよ」
「I knew this whole time that there's no happiness down that path.」	「この道に幸福なんてないってことは分かってたことだった」	I knew this whole time that there's no happiness down that path.	「この道に幸福なんてないってことはわかってた」
「That's why I came here...」	「それがここに来た理由……」	That's why I came here...	「それがここに来た理由……」
「Just so I could get the answer I needed to hear.」	「わたしが必要としてた答えを聞くためだよ」	Just so I could get the answer I needed to hear.	「わたしが必要としてた答えを聞くためだよ」
「And the other thing...」	「あと、さっき言ってたこと……」	And the other thing...	「あと、さっき言ってたこと……」
「You're also right that I just want it to go back to the way it was.」	「全部今まで通りになってほしい、っていうのも正しかったんだ」	You're also right that I just want it to go back to the way it was.	「何もかもが今まで通りになってほしい、っていうのも正しかったんだ」
「I realize that now.」	「今それに気付いたの」	I realize that now.	「今それに気付いたの」
「You really do know me better than anyone, [player].」	「本当に誰よりわたしを理解してるんだね、[player]」	You really do know me better than anyone, [player].	「本当に、誰よりもわたしを理解してるんだね、[player]」
「I'll trust you with anything...」	「[player]なら何でも信頼できるよ……」	I'll trust you with anything...	「[player]のすべてを信じるよ……」
「Anything at all...」	「本当に何でも……」	Anything at all...	「本当に何でも……」
「So...」	「だから……」	So...	「それで……」
Sayori's smile finally breaks.	とうとうサヨリの笑顔が崩れる。	Sayori's smile finally breaks.	とうとうサヨリの笑顔が崩れる。
All of a sudden, she turns around and drops to her knees.	不意に振り返り、膝を抱え込む。	All of a sudden, she turns around and drops to her knees.	そして不意に背中を向けると、膝から崩れ落ちた。
「<i>AAAAAaaaaAAAAAAAAHH!!!!</i>」	「<i>ああああぁぁぁぁああああああっっっっ!!!!!</i>」	<i>AAAAAaaaaAAAAAAAAHH!!!!</i>	「<i>ああああぁぁぁぁああああああっっっっ!!!!!</i>」
Clutching her head with both hands, she screams as loudly as she can.	彼女は両手で頭を抱え、あらんばかりの悲鳴を上げる。	Clutching her head with both hands, she screams as loudly as she can.	彼女は両手で頭を抱え、あらんばかりの悲鳴を上げる。
I'm so shocked that I don't know how to react.	俺はショックのあまり、どんな反応をすればいいのか判らなかった。	I'm so shocked that I don't know how to react.	俺はショックのあまり、何も反応できない。
「...」	「……」	...	「……」
Sayori looks over her shoulder and flashes me one more weak smile before turning around and running off.	サヨリは走り去る直前、後ろを振り返り、もう一度俺にか弱く微笑んだ。	Sayori looks over her shoulder and flashes me one more weak smile before turning around and running off.	サヨリは振り返ってもう一度俺にか弱く微笑み、それから走り去っていく。
「Sayori!」	「サヨリ！」	Sayori!	「サヨリ！」
...	……	...	「……」
I'm left helplessly standing in the front of my house.	俺はどうすることもできずに俺の家の前に立ち尽くしていた。	I'm left helplessly standing in the front of my house.	俺はどうすることもできずに家の前に立ち尽くしていた。
Why am I feeling so horrible about this?	何故俺は罪悪感を感じているんだ？	Why am I feeling so horrible about this?	何故俺は罪悪感を覚えているんだ？
There's nothing more that I could have done.	これ以上俺にできることはない。	There's nothing more that I could have done.	これ以上俺にできることはない。
The most I can do is support Sayori through her feelings and help her on the path that's right.	俺ができることはサヨリを支えてやって、正しい道へと導いてやることだ。	The most I can do is support Sayori through her feelings and help her on the path that's right.	俺ができることはサヨリを支えてやって、正しい道へと導いてやることだ。
But I'm having as much trouble understanding Sayori's feelings as she is.	だが俺もサヨリと同じくらい、彼女の気持ちをよく理解できてない。	But I'm having as much trouble understanding Sayori's feelings as she is.	だが俺もサヨリと同じくらい、彼女の気持ちをよく理解できていない。
Even though I can comfort her...	彼女を慰めることは出来るかもしれないが……	Even though I can comfort her...	彼女を慰めることはできるかもしれないが……
I keep wondering if I should be doing something more, or something different.	もっと何かしてやったり、別のことをしてやれるのでは、と思わざるを得ない。	I keep wondering if I should be doing something more, or something different.	もっと何かしてやったり、別のことをしてやれるのでは、と思わざるを得ない。
I know these thoughts will continue to plague me until things are back to the way they were.	全部元通りになるまで、俺はこの思いにずっと悩まされるだろう。	I know these thoughts will continue to plague me until things are back to the way they were.	すべてが元通りになるまで、俺はこの思いにずっと悩まされるのだろう。
I'm going to give it everything I've got.	俺は自分の全力を尽くしてみせる。	I'm going to give it everything I've got.	俺は自分の全力を尽くしてみせる。
Sayori will always be my dearest friend.	サヨリはずっと、俺の大切な親友だ。	Sayori will always be my dearest friend.	サヨリはずっと、俺の大切な親友なんだ。
And I'll do whatever it takes to put a smile on her face every day.	そして俺はあいつが毎日笑顔でいられるように何でもしてやるんだ。	And I'll do whatever it takes to put a smile on her face every day.	そして俺はあいつが毎日笑顔でいられるように何でもしてやるんだ。
