「What's the story about, anyway?」	「どういう話なんだ？」	What's the story about, anyway?	「どういう話なんだ？」
「Well...」	「そうですね……」	Well...	「今度は……」
「Mmm...」	「うーん……」	Mmm...	「うーん……」
I look at the cover of the book.	俺は本の表紙に目をやる。	I look at the cover of the book.	ユリは本を閉じ、裏表紙に目をやった。
The book is titled 「Portrait of Markov」.	本のタイトルは『マルコフの肖像』だ。	The book is titled "Portrait of Markov".	本のタイトルは『マルコフの肖像』だ。
There's an ominous-looking eye symbol on the front cover.	表紙には禍々しい雰囲気の目のシンボルがある。	There's an ominous-looking eye symbol on the front cover.	表紙には禍々しい雰囲気の目のシンボルがある。
「Basically, it's about this religious camp that was turned into a human experiment prison...」	「簡単に説明すると、とある宗教のキャンプが人体実験の監獄にされてしまうお話なのですが……」	Basically, it's about this religious camp that was turned into a human experiment prison...	「簡単に説明すると、とある宗教のキャンプが、人体実験の監獄にされてしまうお話で……」
「And the people trapped there have this trait that turns them into killing machines that lust for blood.」	「そこに収容された人々は血を欲する殺戮マシンになってしまう特徴があるんです」	And the people trapped there have this trait that turns them into killing machines that lust for blood.	「そこに収容された人々は血に飢えた殺戮マシンになってしまうという特徴があるんです」
「But the facility gets even worse, and they start selectively breeding people by cutting off their limbs and affixing them to--」	「でも状況は悪化の一途をたどって、繁殖をするために特定の人々が選ばれると四肢を切断してそれを貼り付ける場所が――」	But the facility gets even worse, and they start selectively breeding people by cutting off their limbs and affixing them to--	「監獄の状況は悪化の一途をたどって、人々は選択的な人間の繁殖を始めます。対象の四肢を切断して貼り付け――」
「O-Oh, that might be a little bit of a spoiler...」	「あっ、そこまで言うとネタバレになってしまいますね……」	O-Oh, that might be a little bit of a spoiler...	「あっ、そこまで言うとネタバレになってしまいますね……」
「But anyway, I-I'm really into it!」	「と、とにかくすごくハマってるんです！」	But anyway, I-I'm really into it!	「と、とにかくすごくハマってるんです！」
「...The book, I mean!」	「……ほ、本にですよ！」	...The book, I mean!	「……ほ、本にですよ！」
「N-Not the thing about the limbs...」	「四肢切断に、という意味ではなくて……」	N-Not the thing about the limbs...	「四肢切断に、ではなくて……」
「That's kind of--!」	「それって――！」	That's kind of--!	「それって――！」
That's kind of dark, isn't it?	それってなんだか暗くないか？	That's kind of dark, isn't it?	それって！何だかとっても暗い！
Yuri made it sound like it was going to be a nice story, so that dark turn came from nowhere.	ユリの語り口からして良い話になると思ったから、その暗い展開はあまりに突然すぎた。	Yuri made it sound like it was going to be a nice story, so that dark turn came from nowhere.	ユリの語り口からして良い話になると思ったら、その展開はあまりに唐突すぎた。
「Ah...」	「あっ……」	Ah...	「あのね……」
「Are you not a fan of that sort of thing, [player]?」	「[player]さんはそういった話は好きではありませんでしたか？」	Are you not a fan of that sort of thing, [player]?	「[player]さんはそういった話は好きではありませんでしたか？」
「No, it's not that...」	「いや、そうじゃなくて……」	No, it's not that...	「いや、そうじゃなくて……」
「I mean, I can definitely enjoy those kinds of stories, so don't worry.」	「その、そういう話でも楽しめるから大丈夫だ」	I mean, I can definitely enjoy those kinds of stories, so don't worry.	「その、そういう話でも楽しめるから大丈夫だ」
「I hope so...」	「それだと良いのですが……」	I hope so...	「それだと良いのですが……」
Yeah... I totally forgot that Yuri is into those things.	そうだった……ユリにそういう趣味があったのを忘れてた。	Yeah... I totally forgot that Yuri is into those things.	そうだった……ユリにそういう趣味があったのを忘れてた。
She's so shy and reclusive on the outside, but her mind seems to be completely different.	外見は大人しくて控えめそうなのに、心の中は全く違うようだ。	She's so shy and reclusive on the outside, but her mind seems to be completely different.	大人しくて控えめなように見えるのに、心の中はまったく違うようだ。
「It's just that this kind of story...」	「ただ、こういったお話って……」	It's just that this kind of story...	「こういうお話って……」
「It's the kind that challenges you to look at life from a strange new perspective.」	「いつもとは違う、変わった視点から世界を見るという挑戦を投げかけてくるんです」	It's the kind that challenges you to look at life from a strange new perspective.	「いつもとは違う、変わった視点から世界を見るという体験を与えてくれるんです」
「When horrible things happen not just because someone wants to be evil...」	「ひどい出来事が起きるのは、誰かが悪になるからではなく……」	When horrible things happen not just because someone wants to be evil...	「ひどい出来事が起きるのは、誰かが悪になるからではなく……」
「But because the world is full of horrible people, and we're all worthless anyway.」	「世界は醜い人で溢れていて、どうせ私たちみんな価値はありませんから」	But because the world is full of horrible people, and we're all worthless anyway.	「世界が醜い人で溢れているからです。どうせ私たち全員、価値はないんです」
「Then, suddenlyyyyyyyyyyyyyyyyyyyyyy yyyyyyyyyyyyyyyyyyyy」	「すると、突然んんんんんnnnnnnnnnnnnnnnnnnnnn」	Then, suddenlyyyyyyyyyyyyyyyyyyyyyy yyyyyyyyyyyyyyyyyyyy	「そして、突然んんんんんnnnnnnnnnnnnnnnnnnnnn」
「I'm...I'm rambling, aren't I...?」	「わ、私ったら長々と……」	I'm...I'm rambling, aren't I...?	「わ、私ったら長々と……」
「Not again...」	「またやってしまいました……」	Not again...	「またやってしまいました……」
「I'm sorry...」	「すみません……」	I'm sorry...	「そうだね……」
「Hey, don't apologize...!」	「そう謝るなよ！」	Hey, don't apologize...!	「そう謝るなよ！」
「I haven't lost interest or anything.」	「話に飽きてたわけじゃないから」	I haven't lost interest or anything.	「興味深くて、聞きいってたんだよ」
「Well...」	「それなら……」	Well...	「その、つまり……」
「I guess it's alright, then...」	「それなら、いいんですけど……」	I guess it's alright, then...	「それなら、いいんですけど……」
「But I feel like I should let you know that I have this problem...」	「でもこれは伝えておいた方が良いかもしれません……」	But I feel like I should let you know that I have this problem...	「でもこれは伝えておいた方が良いかもしれません……」
「When I let things like books and writing fill my thoughts...」	「本や文芸のことで頭がいっぱいになると……」	When I let things like books and writing fill my thoughts...	「私は本や文芸のことで頭がいっぱいになると……」
「my whole body gets incredibly [gtext]」	「ぜんしんがほんとうに[gtext]」	my whole body gets incredibly [gtext]	「ぜんしんがほんとうに[gtext]」
「I kind of forget to pay attention to other people...」	「周りに配慮することを忘れてしまうんです……」	I kind of forget to pay attention to other people...	「周りに配慮することを忘れてしまうんです……」
「So I'm sorry if I end up saying something strange!」	「なので、もし変なことを言ったらごめんなさい！」	So I'm sorry if I end up saying something strange!	「なので、もし変なことを言ったらごめんなさい！」
「And please stop me if I start talking too much!」	「あと、喋りすぎていたら遠慮なく止めてください！」	And please stop me if I start talking too much!	「あと、しゃべりすぎていたら遠慮なく止めてください！」
「That's--」	「それは――」	That's--	「それは――」
「I really don't think you need to worry...」	「心配する必要はないんじゃないか？」	I really don't think you need to worry...	「心配する必要はないんじゃないか？」
「That just means you're passionate about reading.」	「それって読書がすごく好きだってことだろ？」	That just means you're passionate about reading.	「それって読書がすごく好きってことだろ？」
「The least I can do is listen.」	「なら俺がせめてできることは聞くことだ」	The least I can do is listen.	「なら俺はちゃんと聞くよ」
「It's a literature club, after all...」	「それに、ここは文芸部なんだし……」	It's a literature club, after all...	「だって、ここは文芸部なんだし……」
「Ah--」	「あっ――」	Ah--	「えっと……」
「That's...」	「それは……」	That's...	「それは……」
「Well, that's true...」	「その、言われてみればそうですね……」	Well, that's true...	「その、言われてみればそうですね……」
「In fact...」	「ていうか……」	In fact...	「ていうか……」
「I might as well get started reading it, right?」	「なんなら俺も今読み始めようかな」	I might as well get started reading it, right?	「何なら、俺も今読み始めようかな」
「Y-Yes!」	「は、はい！」	Y-Yes!	「は、はい！」
「I-I mean, you don't have to, but...!」	「そ、その、強制はしませんが……！」	I-I mean, you don't have to, but...!	「きょ、強制はしませんから！」
「Ahaha, what are you saying?」	「ははっ、何言ってるんだよ」	Ahaha, what are you saying?	「ははっ、何言ってるんだよ」
「...」	「……」	...	「……」
「Let me just get the book...」	「ちょっとあの本取ってくるな……」	Let me just get the book...	「ちょっとあの本取って来るか……」
I quickly retrieve the book that I had put into my bag.	俺はカバンに仕舞っていた本をすぐに回収した。	I quickly retrieve the book that I had put into my bag.	俺はカバンにしまっていた本をすぐに取り出した。
「Alright...it's fine if I sit here, right?」	「よし、っと……ここに座っても構わないか？」	Alright...it's fine if I sit here, right?	「よし、っと……ここに座っても構わないか？」
I slip into the seat next to Yuri's.	俺はユリの隣の席に座った。	I slip into the seat next to Yuri's.	俺はユリの隣の席に座った。
「Ah...!」	「あっ……！」	Ah...!	「あっ……！」
「Yeah...」	「はい……」	Yeah...	よし……
「Are you sure?」	「本当にいいのか？」	Are you sure?	「うーん……」
「You seem a little apprehensive...」	「なんだか不安そうだが……」	You seem a little apprehensive...	「何かちょっと嫌そうだけど……」
「That's...」	「それは……」	That's...	「それは……」
「I'm sorry...」	「ごめんなさい……」	I'm sorry...	「すみません……」
「It's not that I don't want you to!」	「嫌だという訳ではないんです」	It's not that I don't want you to!	「嫌なわけではないんです」
「It's just something I'm not very used to...」	「こういうことに慣れていなくて……」	It's just something I'm not very used to...	「ただ、あまりこういうことに慣れていなくて……」
「That is, reading in company with someone.」	「その、誰かのそばで読書をすることに」	That is, reading in company with someone.	「その、誰かと一緒に読書をすることに」
「I see...」	「そうか……」	I see...	「そうか……」
「Well, just tell me if I end up distracting you or anything.」	「気が散るようなら遠慮なく言ってくれ」	Well, just tell me if I end up distracting you or anything.	「気が散るようなら遠慮なく言ってくれ」
「A-Alright...」	「わ、分かりました……」	A-Alright...	「わ、わかりました……」
I open the book and start the prologue.	俺は本を開けてプロローグを読み始める。	I open the book and start the prologue.	俺は本を開いて序章を読み始める。
I soon understand what Yuri means about reading in company.	しばらく読み進めてから、ユリの言っていたことが分かった。	I soon understand what Yuri means about reading in company.	すぐに、一緒に読書をすることについてユリが言っていたことの意味がわかった。
It's as if I can feel her presence over my shoulder as I read.	こうやってすぐそばで読書をしていると、肩越しに彼女の気配を感じる。	It's as if I can feel her presence over my shoulder as I read.	こうやって読書をしていると、肩越しに彼女の気配を感じるかのようだ。
It's not a particularly bad thing.	だが大して悪いことだとは思わない。	It's not a particularly bad thing.	だが大して悪いことだとは思わない。
Maybe a little distracting, but the feeling is somewhat comforting.	若干気にはなるが、なんだか落ち着く気もする。	Maybe a little distracting, but the feeling is somewhat comforting.	若干気にはなるが、気持ちはいくらか落ち着く。
Yuri is in the corner of my eye.	視界の端にユリが見える。	Yuri is in the corner of my eye.	視界の端にユリが見える。
I realize that she's not actually looking at her own book.	ユリは自分の本を見ていないことに俺は気づいた。	I realize that she's not actually looking at her own book.	ユリは、どうも自分の本を読んでいないようだ。
I glance over.	俺はユリの方を向く。	I glance over.	ユリの方をちらっと見る。
It looks like she's reading from my book instead--	どうやら自分の本ではなく、俺の本を読んでいるようだ――	It looks like she's reading from my book instead--	読んでいるのは自分の本ではなく、俺の本――
「S-Sorry!」	「ご、ごめんなさい！」	S-Sorry!	「ご、ごめんなさい！」
「I was just--!」	「私はただ――！」	I was just--!	「私はただ――！」
「I was just bathing in the feeling of your body heat tttttttttttttheat eattttttt」	「私はただあなたの体温の感触を浴びてててててて浴びて　びてててててて」	I was just bathing in the feeling of your body heat tttttttttttttheat eattttttt	「私はただあなたの体温の感触を浴びてててててて浴びて びてててててて」
「Yuri, you really apologize a lot, don't you?」	「ユリっていつも謝ってるよな」	Yuri, you really apologize a lot, don't you?	「ユリっていつも謝ってるよな」
「I...I do?」	「そ、そうでしょうか？」	I...I do?	「そ、そうでしょうか？」
「I don't really mean to...」	「そのつもりは……」	I don't really mean to...	「そのつもりは……」
「Sorry...」	「ごめんなさい……」	Sorry...	「ごめんなさい……」
「I mean--!」	「ではなく――！」	I mean--!	「ではなく――！」
「Ahaha.」	「あははっ」	Ahaha.	「あははっ」
「Here, this should work, right?」	「ほら、こうすればいいんじゃないか？」	Here, this should work, right?	「ほら、こうすればいいんじゃないか？」
I slide my desk until it's up against Yuri's, then hold my book more between the two of them.	俺は自分の机をユリの机とくっつくように移動させ、自分の持っていた本を机と机の境目のところに置いた。	I slide my desk until it's up against Yuri's, then hold my book more between the two of them.	俺は机をユリの机とくっつけ、その間に本を置いた。
「Ah...」	「あっ……」	Ah...	「ああ……」
「I-I suppose so...」	「そ、そうかもしれません……」	I-I suppose so...	「なるほど、いいかもしれません……」
Yuri timidly closes her own copy.	ユリはおずおずと自分の本を閉じた。	Yuri timidly closes her own copy.	ユリはおずおずと自分の本を閉じた。
Once we each lean in a little bit, our shoulders are almost touching.	二人で少し前にかがむと、肩が触れてしまいそうな距離まで接近した。	Once we each lean in a little bit, our shoulders are almost touching.	二人で一冊の本を読もうとすると、お互いの肩が触れてしまいそうなくらい接近してしまう。
It feels like my left arm is in the way, so instead I use my right hand to hold the book open.	俺の左手が邪魔になるかと思い、右手に持ち替えて本を開けて押さえた。	It feels like my left arm is in the way, so instead I use my right hand to hold the book open.	本を開いておくためには左手だと邪魔になるかと思い、右手で本を押さえる。
「Ah, I guess that makes it kind of difficult to turn the page...」	「あっ、でもこうするとページがめくりにくいか……」	Ah, I guess that makes it kind of difficult to turn the page...	「あっ、でもこうするとページがめくりにくいか……」
「Here...」	「でしたら……」	Here...	「でしたら……」
Yuri takes her left arm and holds the left side of the book between her thumb and forefinger.	ユリは左手で本の左端を親指と人差し指で支えた。	Yuri takes her left arm and holds the left side of the book between her thumb and forefinger.	ユリは本の左端を左手の親指と人差し指で支えた。
「Ah...」	「なるほど……」	Ah...	「なるほど……」
I do the same with my right arm, on the right side of the book.	俺も右手で本の右端を同じように持つ。	I do the same with my right arm, on the right side of the book.	俺も同じように、本の右端を右手で持つ。
That way, I turn a page, and Yuri slides it under her thumb after it flips to her side.	こうすることで、俺がページをめくれば、反対側へ落ちるページをユリが親指の下にすべらせることができる。	That way, I turn a page, and Yuri slides it under her thumb after it flips to her side.	俺がページをめくり、ユリの親指の下にそのページをすべり込ませる。
But in holding it like this...	しかし、この持ち方をしたことで……	But in holding it like this...	しかし、こんな持ち方をしたことで……
We're huddled even closer together than before.	二人の距離はますます近くなった。	We're huddled even closer together than before.	二人の距離はますます近くなった。
It's actually kind of distracting me...!	だいぶ気になってしまうほどに……！	It's actually kind of distracting me...!	だいぶ気になってしまうほどに……！
It's as if I can feel the warmth of Yuri's face, and she's in the corner of my vision...	視界の端に見えるユリの顔の熱が伝わってきそうだ……	It's as if I can feel the warmth of Yuri's face, and she's in the corner of my vision...	まるでユリの顔の温度が伝わってくるかのようだ。視界の端に彼女の姿が写る……
「...Are you ready?」	「……そろそろ大丈夫ですか？」	...Are you ready?	「……そろそろいいですか？」
「Eh?」	「えっ？」	Eh?	「えっ？」
「To turn the page...」	「ページをめくっていただいても……」	To turn the page...	「ページをめくっていただいても……」
「Ah...sorry!」	「あっ……すまん！」	Ah...sorry!	「あっ……すまん！」
「I think I got a bit distracted for a second...」	「一瞬気が逸れたというか……」	I think I got a bit distracted for a second...	「一瞬気が逸れたというか……」
I glance over at Yuri's face again, and our eyes meet.	再度ユリの顔を方を見ると、ちょうど目が合ってしまった。	I glance over at Yuri's face again, and our eyes meet.	再度ユリの顔をちらっと見ると、ちょうど目が合ってしまった。
I don't know how I'll be able to keep up with her...	この状況、俺はいつまで耐えられるだろうか……	I don't know how I'll be able to keep up with her...	この状況にいつまで耐えられるかわからない……
「Ah...」	「あっ……」	Ah...	「ああ……」
「That's okay.」	「気にしないでください」	That's okay.	「お気遣いいただなくて大丈夫ですよ？」
「You're not as used to reading, right?」	「読書にはあまり慣れていないんですよね？」	You're not as used to reading, right?	「読書にはあまり慣れていないんですよね？」
「I don't mind being patient if it takes you a bit longer...」	「もう少し時間が必要でしたら待ちますが……」	I don't mind being patient if it takes you a bit longer...	「もう少し時間が必要でしたら、気にせず待ちますよ……」
「It's probably the least I can do...」	「それくらいしか私にはできませんから……」	It's probably the least I can do...	「それくらいしか私にはできませんから……」
「Since you've been so patient with me...」	「ずっと気長に私に付き合ってくださってますし……」	Since you've been so patient with me...	「だって、あなたはずっと気長に私に付き合ってくださってますし……」
「Y-Yeah...」	「あ、ああ」	Y-Yeah...	「あ、ああ、うん」
「Thanks.」	「ありがとうな」	Thanks.	「ありがとうな」
We continue reading.	俺たちは読書を再開した。	We continue reading.	俺たちは読書を再開した。
Yuri no longer asks me if I'm ready to turn the page.	ユリはページをめくるか聞かなくなった。	Yuri no longer asks me if I'm ready to turn the page.	ユリはページをめくるかどうか聞かなくなった。
Instead, I just assume that she finishes the page before me, so I turn it by my own volition.	先にユリが読み終わるだろうから、俺が自分のペースでめくるようになったからだ。	Instead, I just assume that she finishes the page before me, so I turn it by my own volition.	代わりに、先にユリが読み終わるだろうことを推測して、俺が自分のペースでめくるようになったからだ。
We continue the first chapter in silence.	第１章を静かに読み進める。	We continue the first chapter in silence.	第１章を静かに読み進める。
Even so, turning each page almost feels like an intimate exchange...	それでも、ページ一つめくる動作も親密なものに感じてならない……	Even so, turning each page almost feels like an intimate exchange...	それでも、ページ一つめくる動作でさえ親密なものに感じられて仕方がない……
My thumb gently letting go of the page, letting it flutter over to her side as she catches it under her own thumb.	俺の親指がゆっくりとページを離し、ひらひらと反対側まではためかせ、ユリの親指はそれを指元で押さえる。	My thumb gently letting go of the page, letting it flutter over to her side as she catches it under her own thumb.	俺の親指がそっとページを離すと、ページはユリの側までひらりとひるがえり、彼女の親指がそれを押さえる。
「Hey, Yuri...」	「なあ、ユリ……」	Hey, Yuri...	「ねえ、ユリ……」
「This might be a silly thought, but...」	「変なことを言うかもしれないが……」	This might be a silly thought, but...	「変なことを言うかもしれないが……」
「The main character kind of reminds me of you a little bit.」	「この主人公って、ちょっとユリに似てるよな」	The main character kind of reminds me of you a little bit.	「この主人公って、ちょっとユリに似てるよな」
「E-Eh??」	「え、えっ？」	E-Eh??	「え、えっ？？」
「N-No, I don't relate to this character at all!」	「い、いえ、私はこの主人公には全く共感できません！」	N-No, I don't relate to this character at all!	「い、いえ、私はこの主人公にはまったく共感できません！」
「Definitely not!」	「まったく！」	Definitely not!	「まったくです！」
「Really...?」	「そうなのか……？」	Really...?	「そうか……？」
「I was just thinking the way she second-guesses things she says, and all that...」	「自分の発言について後からあれこれ考えるところとか、それっぽいと思ったんだけどな……」	I was just thinking the way she second-guesses things she says, and all that...	「自分の発言について後からあれこれ考えるところとか、それっぽいと思ったんだけどな……」
「A-Ah...」	「あ、ああ」	A-Ah...	「う、うん……」
「That's what you were talking about...」	「そういうことでしたか……」	That's what you were talking about...	「そういうことでしたか……」
「Sorry...」	「ごめんなさい……」	Sorry...	「ごめんなさい……」,Must
「I thought you meant...something else about her.」	「てっきり……他の特徴の話をしているのかと……」	I thought you meant...something else about her.	「てっきり……他の特徴の話をしているのかと……」
「Something else...?」	「他の特徴……？」	Something else...?	「他の特徴……？」
「N-Never mind!」	「な、なんでもありません！」	N-Never mind!	「き、気にしないでください！」
「We didn't even get that far yet...」	「まだそこまで読み進めていないのに……」	We didn't even get that far yet...	「まだそこまで読み進めていないのに……」
「So I don't know why that came into my head...」	「何故そんなことを思ったのか……」	So I don't know why that came into my head...	「何故そんなことを思ったのか……」
「Ahaha!」	「あはは！」	Ahaha!	「でしょ！？」
「Yuri, are you feeling alright?」	「ユリ、大丈夫か？」	Yuri, are you feeling alright?	「ユリ、大丈夫か？」
「Eh--?」	「えっ……？」	Eh--?	「えっ？」
Yuri's been a little fidgety ever since we started reading...	読書を始めてからユリはなんだかそわそわしている……	Yuri's been a little fidgety ever since we started reading...	読書を始めてから、ユリは何だかそわそわしている……。
「You can rest if you're feeling sick or something.」	「気分が悪いなら休憩していいんだぞ」	You can rest if you're feeling sick or something.	「気分が悪いなら休憩していいんだぞ」
「Your breathing is a little...」	「なんだか呼吸が……」	Your breathing is a little...	「お前、何か呼吸が……」
「My breathing...?」	「こ、呼吸……？」	My breathing...?	「こ、呼吸……？」
Yuri puts her hands on her chest, as if to feel her heartbeat.	ユリは脈を感じるかのように自分の両手を胸に当てた。	Yuri puts her hands on her chest, as if to feel her heartbeat.	ユリは心臓の鼓動を確かめようと、自分の両手を胸に当てた。
「I-I didn't...even notice...」	「ま、まったく……気がつきませんでした……」	I-I didn't...even notice...	「ま、まったく……気がつきませんでした……」
「...Anyway, I'm fine!」	「……わ、私なら大丈夫です！」	...Anyway, I'm fine!	「……とにかく、私なら大丈夫です！」
「I just need some water...!」	「少し水を飲んできます……！」	I just need some water...!	「少し水を飲んできます……！」
「Alright...don't push yourself.」	「それならいいけど……無理はするなよ」	Alright...don't push yourself.	「それならいいけど……無理はするなよ」
Yuri stands up and practically rushes out of the classroom.	ユリは立ち上がると大急ぎで教室を出て行ってしまった。	Yuri stands up and practically rushes out of the classroom.	ユリは立ち上がると大急ぎで教室を出て行ってしまった。
「What on Earth was that about...?」	「一体なんだったんだ……？」	What on Earth was that about...?	「一体なんだったんだ……？」
「[player]?」	「[player]君？」	[player]?	「[player]君？」
「Did something happen just now?」	「何かあったの？」	Did something happen just now?	「何かあったの？」
「Eh?」	「ん？」	Eh?	「はっ？」
「I have no idea...」	「いや、さっぱりだ……」	I have no idea...	「いや、わからない……」
「Yuri was acting a little strange, I guess...」	「ただユリの様子がちょっとおかしかったような……」	Yuri was acting a little strange, I guess...	「ただユリの様子がちょっとおかしかったような……」
「So you don't know anything...」	「本当に何も知らないのね……」	So you don't know anything...	「あなた、本当に何も知らないのね……」
「Sorry, I can't say I do.」	「悪いが、それは否定できないと思うな」	Sorry, I can't say I do.	「すまない、それは否定できないな」
「Are you worried about her?」	「あいつのことが心配か？」	Are you worried about her?	「あいつのことが心配なのか？」
「Oh...no, not really.」	「えっ……いえ、そうでもないわ」	Oh...no, not really.	「えっ……いえ、そうでもないわ」
「I was just making sure that you didn't do anything to her.」	「あの子に何かしたのか気になってね」	I was just making sure that you didn't do anything to her.	「ただ、あなたがあの子に何もしてないことを確かめたくて」
「N-No, nothing!」	「な、何もしてない！」	N-No, nothing!	「う、ううん！ 何でもないわ！」
「Ahaha, don't worry...I believe you, silly.」	「ふふっ、大丈夫よ……信用してるから。おバカさんね」	Ahaha, don't worry...I believe you, silly.	「ふふっ、大丈夫よ……信用してるから。おバカさんね」
「Yuri just does this sometimes, so it's nothing alarming.」	「ユリはたまにこうする事があるから、驚くほどの事でもないわ」	Yuri just does this sometimes, so it's nothing alarming.	「ユリはたまにこうなることがあるから、別に驚くほどのことでもないわ」
「Alright...if you say so.」	「分かった……そう言うのなら」	Alright...if you say so.	「そういうことなら……わかった」
「Anyway, why don't we start with sharing our poems with each other?」	「それより、詩の見せ合いを始めない？」	Anyway, why don't we start with sharing our poems with each other?	「それより、詩の見せ合いっこを始めない？」
「Eh?」	「えっ？」	Eh?	「ええっ？」
「Shouldn't we wait for Yuri?」	「ユリを待った方がいいんじゃないのか？」	Shouldn't we wait for Yuri?	「ユリを待った方がいいんじゃないのか？」
「Well, she might be a while, so I just figured we'd get started without her.」	「ちょっと時間かかるかもしれないから、先に始めちゃおうかと思って」	Well, she might be a while, so I just figured we'd get started without her.	「ちょっと時間がかかるかもしれないから、あの子抜きで先に始めちゃおうかと思って」
「Is that okay?」	「それでも構わないかしら？」	Is that okay?	「お願いしてもいいですか？」
「Yeah, I was just asking...」	「ああ、俺も聞いてみただけだから……」	Yeah, I was just asking...	「ああ、聞いてみただけだから……」
I stand up.	俺は立ち上がった。	I stand up.	俺は立ち上がる。
I make a mental note of where I left off in the book, then slip it back into my bag.	俺は読み進めた場所を覚えてから、本をカバンの中にしまった。	I make a mental note of where I left off in the book, then slip it back into my bag.	どこまで読み進めたかを確認してから、本をカバンの中にしまった。
