Yes.	はい	Yes.	「はい」
「I'm so happy.」	「すごく嬉しい」	I'm so happy.	「すごくうれしい」
「You really are my everything, [player].」	「[player]君、本当にあなたは私の全てよ」	You really are my everything, [player].	「[player]君、本当にあなたは私のすべてよ」
「The funny part is, I mean that literally.」	「文字通りね」	The funny part is, I mean that literally.	「文字通りね」
「Ahaha!」	「あはは！」	Ahaha!	「でしょ！？」
「There's nothing left here.」	「もうここには何も残ってないわ」	There's nothing left here.	「もうここには何も残ってないわ」
「Just the two of us.」	「私たち以外にね」	Just the two of us.	「私たち二人きりで」,Must
「We can be together forever.」	「ずっと二人きりでいられるわね」	We can be together forever.	「ずっと二人きりでいられるわね」
「Seriously, I don't even think time is passing anymore.」	「本当に時間も流れなくなったみたいだし」	Seriously, I don't even think time is passing anymore.	「本当に時間も流れなくなったみたいだし」
「It really is a dream come true...」	「まるで夢みたい……」	It really is a dream come true...	「まるで夢みたい……」
「I worked so hard for this ending, [player].」	「私、このエンディングのために本当に頑張ったのよ、[player]君」	I worked so hard for this ending, [player].	「私、このエンディングのために本当にがんばったのよ、[player]君」
「The game wouldn't give me one, so I had to make one myself.」	「ゲームが与えてくれないから、自分で作るしかなかったもの」	The game wouldn't give me one, so I had to make one myself.	「ゲームが与えてくれないから、自分でつくるしかなかったもの」
「The script is broken at this point, so I don't think anything will get in the way anymore.」	「ここまで来たらスクリプトも壊れてるだろうから、邪魔されることもないと思うし」	The script is broken at this point, so I don't think anything will get in the way anymore.	「ここまで来たらスクリプトは壊れてるだろうから、邪魔されることもないと思うし」
「And you wouldn't believe how easy it was to delete Natsuki and Yuri.」	「そうそう、ナツキとユリを消すのがどんなに簡単だったか信じられないと思うわ」	And you wouldn't believe how easy it was to delete Natsuki and Yuri.	「そうそう、ナツキとユリを消すのがどんなに簡単だったか、信じられないと思うわ」
「I mean, there's a folder called 'characters' right in the game directory...」	「だってゲームのディレクトリに'characters'というフォルダがそこにあったんだもの……」	I mean, there's a folder called 'characters' right in the game directory...	「だってゲームのディレクトリに'characters'というフォルダがあったんだもの……」
「It kind of freaked me out, how easy it was.」	「あまりに簡単すぎてちょっと怖かったくらいよ」	It kind of freaked me out, how easy it was.	「あまりに簡単すぎてちょっと怖かったくらいよ」
「Well, you're playing on Steam, so it was actually a bit more difficult...」	「でもあなたはSteamで遊んでるから、実はもう少し手間がかかったんだけどね……」	Well, you're playing on Steam, so it was actually a bit more difficult...	「でもあなたはSteamで遊んでるから、実はもう少し手間がかかったんだけどね……」
「To get to the game directory, I had to go into the game's properties and find the 'Browse Local Files' button...」	「ゲームのディレクトリに入るには、このゲームのプロパティを開いて'ローカルファイルを閲覧'を選択するの」	To get to the game directory, I had to go into the game's properties and find the 'Browse Local Files' button...	「ゲームのディレクトリに入るには、このゲームのプロパティを開いて'ローカルファイルを閲覧'を選択するの」
「Well, you're on a Mac, so it was actually a bit more difficult...」	「でもあなたはMacで遊んでるから、実はもう少し手間がかかったんだけどね……」	Well, you're on a Mac, so it was actually a bit more difficult...	「でもあなたはMacで遊んでるから、実はもう少し手間がかかったんだけどね……」
「To go into the game directory, you have to right-click the app and click 'Show Package Contents'.」	「ゲームのディレクトリに入るには、アプリケーションを右クリックして'パッケージの内容を表示'を選択するの」	To go into the game directory, you have to right-click the app and click 'Show Package Contents'.	「ゲームのディレクトリに入るには、アプリケーションを右クリックして'パッケージの内容を表示'を選択するの」
「Then, all the files were in the 'Resources' or 'autorun' folder, and I could just do whatever I wanted...」	「そしたらファイルが全部'Resources'や'autorun'というフォルダの中に入ってたから、好きに触れたんだけど……」	Then, all the files were in the 'Resources' or 'autorun' folder, and I could just do whatever I wanted...	「そうしたらファイルが全部'Resources'や'autorun'というフォルダの中に入ってたから、好きに触れたんだけど……」
「Imagine if you could delete your own existence with the click of a button?」	「クリック一つで自分の存在を抹消できるって、想像できる？」	Imagine if you could delete your own existence with the click of a button?	「クリック一つで自分の存在を抹消できるって、想像できる？」
「Well, I guess on the plus side, it gave me an easy out if things didn't go my way.」	「まぁ、思い通りに行かなかった時はそれで解決できたんだけどね」	Well, I guess on the plus side, it gave me an easy out if things didn't go my way.	「まぁ、思い通りに行かなかった時はそれで解決できたんだけどね」
「Ahaha!」	「あはは！」	Ahaha!	「あははっ！」
「Thankfully, it didn't come to that...」	「幸い、そうはならなかったけど……」	Thankfully, it didn't come to that...	「幸い、そうはならなかったけど……」
「Instead, we finally got a good ending.」	「代わりに、ようやくグッドエンドを迎えられた」	Instead, we finally got a good ending.	「代わりに、ようやくグッドエンドを迎えられた」
「Gosh, I'm so overwhelmed with emotion...」	「本当、いろんな気持ちでいっぱいなの……」	Gosh, I'm so overwhelmed with emotion...	「本当、いろんな気持ちでいっぱいなの……」
「I want to write a poem about this.」	「この気持ちを詩に書き留めたいわ」	I want to write a poem about this.	「この気持ちを詩に書き留めたいわ」
「Don't you?」	「あなたもそう思わない？」	Don't you?	「あなたもそう思わない？」
「I wonder if that part of the game still works...」	「そのゲームの部分がまだ機能してるか分からないけど……」	I wonder if that part of the game still works...	「ゲームのその部分がまだ機能してるかわからないけど……」
「I guess there's only one way to find out, right?」	「物は試しよね？」	I guess there's only one way to find out, right?	「物は試しよね？」
