Another day passes, and it's time for the club meeting already.	一日が過ぎ、部活の時間がやってきた。	Another day passes, and it's time for the club meeting already.	一日が過ぎ、部活の時間がやってきた。
I've gotten a little more comfortable here over the past couple days.	ここ数日でいくらかこの場所も居心地が良くなってきたように思う。	I've gotten a little more comfortable here over the past couple days.	ここ数日で、いくらかこの場所も居心地が良くなってきたように思う。
Entering the clubroom, the usual scene greets me.	部室に入ると、いつもの光景が俺を出迎えてくれる。	Entering the clubroom, the usual scene greets me.	部室に入ると、いつもの光景が俺を出迎えてくれる。
「Hi [player]~」	「あっ、[player]～」	Hi [player]~	「あっ、[player]～」
「Yo, Sayori.」	「よお、サヨリ」	Yo, Sayori.	「よお、サヨリ」
「Looks like you're in a good mood today.」	「今日はご機嫌じゃないか」	Looks like you're in a good mood today.	「今日はご機嫌じゃないか」
「Ehehe~」	「えへへ～」	Ehehe~	「うふふ」
「I'm just still not used to you being in the club, that's all.」	「まだ[player]が部活にいるのが新鮮でね」	I'm just still not used to you being in the club, that's all.	「まだ[player]が部活にいるのが新鮮でね」
「I see...」	「そうか……」	I see...	「そうか……」
「...That's a pretty simple thing to get you in a good mood.」	「……単純な理由だな」	...That's a pretty simple thing to get you in a good mood.	「……よくそんな単純な理由でご機嫌になれるな」
「But I guess it's always the simple things with you, anyway.」	「でも、お前はいつもそんな感じだよな」	But I guess it's always the simple things with you, anyway.	「でも、お前はいつもそんな感じだよな」
「Speaking of which...」	「それはそうと……」	Speaking of which...	「それはそうと……」
「I'm kinda hungry...」	「なんだかお腹空いてきちゃった……」	I'm kinda hungry...	「何だかお腹空いてきちゃった……」
「Will you come with me to buy a snack?」	「一緒にお菓子買いに行かない？」	Will you come with me to buy a snack?	「一緒にお菓子買いに行かない？」
「No thanks.」	「遠慮しとくよ」	No thanks.	「遠慮しとくよ」
「Eh??」	「え？」	Eh??	「は？？」
「T-That's not like you at all!!」	「そ、そんな、らしくないよ！」	T-That's not like you at all!!	「そ、そんな、らしくないよ！」
「I have my reasons.」	「理由はいくつかある」	I have my reasons.	「理由はいくつかある」
「Why don't we take a look at your purse, Sayori?」	「サヨリ、財布の中身を見せてくれないか？」	Why don't we take a look at your purse, Sayori?	「サヨリ、財布の中身を見せてくれないか？」
「E-Eh?」	「え、えー？」	E-Eh?	「は、はい？」
「Why that...all of a sudden?」	「どうしたの、そんな……突然？」	Why that...all of a sudden?	「どうしたの、そんな……突然？」
「No reason, really.」	「いや、別に」	No reason, really.	「いいから」
「I just wanted to look at it.」	「ただちょっと気になってな」	I just wanted to look at it.	「ちょっと気になるんだ」
「A-Ah...」	「あ、あー……」	A-Ah...	「う、うん……」
Sayori nervously retrieves her coin purse.	サヨリはおずおずと小銭入れを取り出す。	Sayori nervously retrieves her coin purse.	サヨリはおずおずと小銭入れを取り出す。
She fumbles with the latch and gets it open.	少してこずりながらも留め金を外し口を開ける。	She fumbles with the latch and gets it open.	少してこずりながらも留め金を外し口を開ける。
Then, she turns it upside-down and lets its contents spill onto the desk.	そして、ひっくり返して机の上に中身を出す。	Then, she turns it upside-down and lets its contents spill onto the desk.	そして、ひっくり返して机の上に中身を出す。
Only two small coins fall out.	出てきたのはお菓子を買うにはとても足りない二枚の小銭だけだった。	Only two small coins fall out.	出てきたのは二枚の小銭だけだった。
「A-Ahaha...」	「あ、あはは……」	A-Ahaha...	「あ、あはは……」
「I knew it...」	「そんなことだろうと思ったよ……」	I knew it...	「やっぱりな……」
「I can see right through you, Sayori.」	「全部お見通しだ、サヨリ」	I can see right through you, Sayori.	「全部お見通しだ、サヨリ」
「That's not fair!」	「ずるーい！」	That's not fair!	「ずるーい！」
「How did you even know?」	「なんで分かったの？」	How did you even know?	「どうしてわかったの？」
「It's simple.」	「簡単なことさ」	It's simple.	「簡単さ」
「If you had enough money in the first place, you would have bought a snack before coming to the clubroom.」	「もし金を持っているなら、部室に来るまでに既に何か買ってきているはずだ」	If you had enough money in the first place, you would have bought a snack before coming to the clubroom.	「もしお金を持っているなら、部室に来るまでに何か買ってきているはずだ」
「So, either you're not hungry and wanted an excuse to take a walk...」	「そうしていないということはつまり、今お前は本当は腹が減っていないか、散歩する理由を探していたかのどちらかということになる」	So, either you're not hungry and wanted an excuse to take a walk...	「そうしていないということはつまり、本当は腹が減っていなくて、散歩する理由を探していたか……」
「Or, you planned to conveniently forget that you spent all your money, so that I would lend you some!」	「もしくは、金を使い果たしたことを都合よく忘れて、俺から金を借りるつもりだったかだ！」	Or, you planned to conveniently forget that you spent all your money, so that I would lend you some!	「もしくは、金を使い果たしたことを都合よく忘れて、俺から金を借りるつもりだったかだ！」
「But there's one more thing...」	「そしてもうひとつ……」	But there's one more thing...	「そしてもう一つ……」
「...You're always hungry!」	「……お前はいつも腹が減ってるじゃないか！」	...You're always hungry!	「……お前はいつも腹が減ってるじゃないか！」
「And so, that only leaves the one option!」	「だから答えはひとつしかないんだよ！」	And so, that only leaves the one option!	「だから答えは一つしかないんだよ！」
「Uwaaa~!」	「うわあああ～！」	Uwaaa~!	「うわあああ～！」
「I give up!」	「降参だよ！」	I give up!	「降参だよ！」
「Don't make me feel guiltyyy!」	「これ以上わたしを責めないで～！」	Don't make me feel guiltyyy!	「これ以上わたしを責めないで～！」
「If you feel guilty, that means you deserve to feel guilty...」	「罪悪感を覚えるってことは、やっぱり心当たりがあるんだな……」	If you feel guilty, that means you deserve to feel guilty...	「罪悪感を覚えるってことは、やっぱり心当たりがあるんだな……」
「Ahaha.」	「ふふふ」	Ahaha.	「あははっ」
Yuri suddenly giggles.	ユリが突然くすくすと笑った。	Yuri suddenly giggles.	ユリが突然くすくすと笑った。
「Eh?」	「ん？」	Eh?	「えっ？」
I didn't notice that she was listening in.	ユリが聞いていたとは気が付かなかった。	I didn't notice that she was listening in.	ユリが聞いていたとは気がつかなかった。
Her face is in her book, as always.	ユリの視線はいつものように本に向いている。	Her face is in her book, as always.	ユリの視線は、いつものように本に向いている。
「A-Ah!」	「……あっ！」	A-Ah!	「あ、あっ……！」
「I wasn't listening or anything--!」	「聞いていたのではなくて……！」	I wasn't listening or anything--!	「聞いていたのではなくて……！」
「It was just...something in my book...」	「ただ、本に……面白いところがあって……」	It was just...something in my book...	「ただ、本に……面白いところがあって……」
「Yuriiii...」	「ユリちゃぁぁぁん～……」	Yuriiii...	「ユリちゃぁぁぁん～……」
「Tell [player] to let me borrow some money...」	「[player]にお金貸してくれるように言ってよぉ～……」	Tell [player] to let me borrow some money...	「[player]にお金貸してくれるように言ってよぉ～……」
「That's--!」	「それは……」	That's--!	「えっ――！」
「Don't get me involved like that, Sayori...」	「サヨリちゃん、私をそうやって巻き込むのはやめてください」	Don't get me involved like that, Sayori...	「サヨリちゃん、私をそうやって巻き込むのはやめてください」
「Besides...」	「それに……」	Besides...	「それに……」
「You should only buy what you can responsibly afford...」	「余裕のある範囲で買えるものだけを買うべきですよ」	You should only buy what you can responsibly afford...	「余裕のある範囲で買えるものだけを買うべきですよ」
「And frankly, after pulling a mischievous little stunt like that, your suffering is fair enough retribution.」	「さらに言えば、騙そうだなんて考えていたんですから、因果応報です」	And frankly, after pulling a mischievous little stunt like that, your suffering is fair enough retribution.	「さらに言えば、騙そうだなんて考えていたんですから、因果応報です」
「...」	「……」	...	「……」
「Ah--!」	「あ……！」	Ah--!	「あ――！」
「Did I just...」	「わ、私……」	Did I just...	「今、私……」
「I-I didn't mean that!!」	「そ、そういう意味ではなくて！」	I-I didn't mean that!!	「そ、そんなつもりはなくて！」
「I got too absorbed into my book...」	「少し本に熱中していて……」	I got too absorbed into my book...	「少し本に熱中していて……」
「Uu...」	「うう……」	Uu...	「うう……」
「Ahaha!」	「あはは！」	Ahaha!	「でしょ！？」
「I really like when you speak your mind, Yuri...」	「思ったことを言ってくれるとこ、わたしは好きだよ、ユリちゃん」	I really like when you speak your mind, Yuri...	「思ったことを言ってくれるとこ、わたしは好きだよ、ユリちゃん」
「It doesn't happen much, but it's a fun side of you!」	「珍しいことだけど、ユリちゃんの楽しい一面だよ！」	It doesn't happen much, but it's a fun side of you!	「そんなの言うなんて珍しいけど、ユリちゃんの新しい、楽しい一面だよ！」
「That's...」	「そんな……」	That's...	「それは……」
「There's no way you could think that...」	「そんなあなたが思っているようなことでは……」	There's no way you could think that...	「そんなあなたが思っているようなことでは……」
「You were right, though...」	「でもそうだよね……」	You were right, though...	「でもそうだよね……」
「I did something bad and now I have to accept the revolution.」	「わたしは悪いことをしちゃったんだから、ヒャッカセイホウだよね……」	I did something bad and now I have to accept the revolution.	「わたしは悪いことをしちゃったんだから、ヒャッカセイホウだよね……」
「Retribution...」	「因果応報……」	Retribution...	「因果応報……」
「That!」	「そう、それ！」	That!	「そう、それ！」
「Still, coming from you, Sayori...」	「しかし、あなたからそういう言葉が出てくるとは……」	Still, coming from you, Sayori...	「でも、あなたからそういう言葉が出てくるとは……」
「I guess there's a little devil inside all of us, isn't there?」	「私たちはみんな、心の中に小さな悪魔を飼っているということですね……」	I guess there's a little devil inside all of us, isn't there?	「私たちはみんな、心の中に小さな悪魔を飼っているということですね……」
「Ehehe...」	「えへへ……」	Ehehe...	「だから……えへへ……」
「Don't let her fool you.」	「騙されるなよ」	Don't let her fool you.	「騙されるなよ」
「Sayori knows exactly what she's doing.」	「サヨリは自分のやってることを分かってるんだ」	Sayori knows exactly what she's doing.	「サヨリは自分のやってることをわかってるんだ」
「After all, she told you guys she was bringing me to the club before she even told me...」	「俺を部室に連れてきたときだって、俺に言う前に先にみんなに『連れてくる』って言ってたしな……」	After all, she told you guys she was bringing me to the club before she even told me...	「俺を部室に連れてきたときだって、俺に言う前にみんなに『連れてくる』って言ってたしな……」
「B-But...!」	「で、でも……！」	B-But...!	「で、でも……！」
「You wouldn't have come if it weren't for the cupcakes...」	「カップケーキが無かったら来なかっただろうから……」	You wouldn't have come if it weren't for the cupcakes...	「カップケーキがなかったら来なかったでしょ……」
「So I had to trick Natsuki into making them!」	「だから作ってもらえるようにナツキちゃんを騙すしかなかったの！」	So I had to trick Natsuki into making them!	「だから、つくってもらうためにナツキちゃんを騙すしかなかったの！」
「Come on, give me more credit than that, Sayori.」	「おいおい、俺をもっと信用してくれよ、サヨリ……」	Come on, give me more credit than that, Sayori.	「おいおい、俺をもっと信用してくれよ、サヨリ……」
「Ehehe...」	「えへへ……」	Ehehe...	「えへへ……」
<i>Pwap!</i>	<i>パシン！</i>	Out of nowhere, something smacks Sayori in the face and tumbles onto the desk.	どこからともなく、何かがサヨリの顔に当たり、机の上に転がる。
「Kyaa--!」	「きゃあ！」	<i>Pwap!</i>	<i>パシン！</i>
Out of nowhere, something smacks Sayori in the face and tumbles onto the desk.	どこかから飛んできた何かがサヨリの顔にぶつかって机の上に落ちる。	Kyaa--!	「きゃあ！」
「Ow...」	「いたた……」	Ow...	「いたた……」
「What was--」	「何これ……」	What was--	「何これ……」
「Eh??」	「え？」	Eh??	「は？？」
「A-A cookie!」	「く、クッキーだー！」	A-A cookie!	「く、クッキーだー！」
Sure enough, it's a giant cookie wrapped in plastic.	確かに、ラップに包まれた大きなクッキーだ。	Sure enough, it's a giant cookie wrapped in plastic.	確かに、ラップに包まれた大きなクッキーだ。
Sayori glances around.	サヨリは辺りを見回す。	Sayori glances around.	サヨリは辺りを見回す。
「I-Is this a miracle??」	「こ、これは奇跡……？」	I-Is this a miracle??	「こ、これは奇跡……？」
「It's because I paid my restitution!」	「わたしの行いのイントクヨウホウ！？」	It's because I paid my restitution!	「わたしの行いのイントクヨウホウ！？」
「Retribution...」	「因果応報……」	Retribution...	「陰徳陽報……」
「Actually, that one almost worked...」	「いえ、これは間違っているというわけでも……」	Actually, that one almost worked...	「そんな言葉が出て来るとは……」
「Ahahaha!」	「あははは！」	Ahahaha!	「あはははっ！」
「I <i>was</i> just gonna give it to you.」	「普通に渡すつもりだったんだけど」	I <i>was</i> just gonna give it to you.	「普通に渡すつもり<i>だった</i>んだけど」
「But then I heard you blab about the cupcakes.」	「カップケーキについて話してるのが聞こえたから」	But then I heard you blab about the cupcakes.	「カップケーキについて話してるのが聞こえたから」
「It was totally worth seeing your reaction, though. Ahaha!」	「あんたのリアクション面白かったわ！ あはは！」	It was totally worth seeing your reaction, though. Ahaha!	「アンタのリアクション面白かったわ！ あはは！」
「N-Natsuki!」	「ナ、ナツキちゃん！」	N-Natsuki!	「ナ、ナツキちゃん！」
「That's so nice of you!」	「最高だよ！」	That's so nice of you!	「最高だよ！」
「I'm so happy...」	「わたし、幸せだよぉー……」	I'm so happy...	「わたし、幸せだよぉー……」
Sayori hugs the cookie.	サヨリはクッキーを抱きしめている。	Sayori hugs the cookie.	サヨリはクッキーを抱きしめている。
「Jeez, just eat it...」	「まったく、いいから食べろよ……」	Jeez, just eat it...	「まったく、いいから食べろよ……」
Sayori rapidly tears open the wrapper and takes a big bite.	サヨリは手早くラップをはがし、大きくかぶりついた。	Sayori rapidly tears open the wrapper and takes a big bite.	サヨリは手早くラップをはがし、大きくかぶりついた。
「Sho good...」	「ひゅっごくおいひい……」	Sho good...	「ひゅっごくおいひい……」
「Mmf--!」	「……んむ！」	Mmf--!	「……んむ！」
Sayori suddenly clasps her hands over her mouth.	サヨリは突然口を手で覆う。	Sayori suddenly clasps her hands over her mouth.	サヨリは突然口を手で覆う。
「I bit my tongue...」	「舌噛んじゃった……」	I bit my tongue...	「舌噛んじゃった……」
「Ehehe.」	「ふふ」	Ehehe.	「ふふ」
「You're going through a lot over just one cookie.」	「たった一枚のクッキーで大騒ぎしすぎ」	You're going through a lot over just one cookie.	「たった一枚のクッキーで大騒ぎしすぎだって」
Natsuki takes a bite of her own cookie.	ナツキは自分のクッキーを一口かじる。	Natsuki takes a bite of her own cookie.	ナツキは自分のクッキーを一口かじる。
「Ah, yours looks really good too, Natsuki!」	「あー、そっちのクッキーもおいしそう！」	Ah, yours looks really good too, Natsuki!	「あー、そっちのクッキーもおいしそう！」
「Can I try it?」	「食べてみていい？」	Can I try it?	「食べてみていい？」
「Jeez...」	「まったく……」	Jeez...	「はあ……」
「Beggars can't be choosers!」	「あんた、選べる立場だとでも思ってるの？」	Beggars can't be choosers!	「アンタ、選べる立場だとでも思ってるの？」
「But yours is chocolate...」	「でも、そっち、チョコだし……」	But yours is chocolate...	「でも、そっち、チョコだし……」
「Yeah, why do you think I gave you that one?」	「そうよ、だからチョコじゃないほうをあんたに渡したの」	Yeah, why do you think I gave you that one?	「そうよ、だからチョコじゃない方をアンタに渡したの」
「Fine...」	「そっか……」	Fine...	「そっか……」
「Still, I'm really happy that you shared this one with me.」	「でも、わたしにこのクッキーをくれたのは嬉しいよ」	Still, I'm really happy that you shared this one with me.	「でも、わたしにこのクッキーをくれたのはうれしいよ」
「Ehehe~」	「えへへ～」	Ehehe~	「うふふ」
Sayori gets out of her seat and goes behind Natsuki, then wraps her arms around her.	サヨリは席を離れて、ナツキの後ろから体に腕を回す。	Sayori gets out of her seat and goes behind Natsuki, then wraps her arms around her.	サヨリは席を離れて、ナツキの後ろから体に腕を回す。
「Ah-- Jeez...」	「ああもう……」	Ah-- Jeez...	「ああもう……」
「I get it, I get it.」	「分かった、分かったから」	I get it, I get it.	「わかった、わかったから」
Cookie still in hand, Natsuki reaches up to nudge Sayori off of her.	クッキーを手にした方の手で、ナツキはサヨリを遠ざけようとする。	Cookie still in hand, Natsuki reaches up to nudge Sayori off of her.	クッキーを手にした方の手で、ナツキはサヨリを遠ざけようとする。
「...<i>Om.</i>」	「……あむ」	...<i>Om.</i>	「……<i>あむ</i>」
Sayori suddenly leans down and takes a bite out of Natsuki's cookie.	急にサヨリは屈みこみ、ナツキのクッキーにかじりついた。	Sayori suddenly leans down and takes a bite out of Natsuki's cookie.	急にサヨリは屈みこみ、ナツキのクッキーにかじりついた。
「<i>H-Hey!!</i>」	「ちょ、ちょっと！」	<i>H-Hey!!</i>	「<i>ちょ、ちょっと！</i>」
「Did you seriously just do that?!」	「あんた、ほんとに何してんの！？」	Did you seriously just do that?!	「アンタ、ホントに何してんの！？」
「Uhuhuhu!」	「うふふふ！」	Uhuhuhu!	「うふふふ！」
Mouth full, Sayori trots away to safety.	口いっぱいに頬張りながらサヨリは逃げ出す。	Mouth full, Sayori trots away to safety.	口いっぱいに頬張りながらサヨリは逃げ出す。
Yuri and I laugh as well.	ユリと俺も笑う。	Yuri and I laugh as well.	ユリと俺も笑う。
「Jeez! You're such a kid sometimes!」	「もう！ たまに本当に子供っぽいことするんだから！」	Jeez! You're such a kid sometimes!	「もう！ 本当に子どもみたいなことするんだから！」
「Monika! Can you tell Sayori--」	「モニカ！ サヨリに何か言ってやっ……」	Monika! Can you tell Sayori--	「モニカ！ サヨリに何か言ってやっ……」
「--Eh?」	「……って？」	--Eh?	「……って？」
Natsuki glances around.	ナツキは辺りを見回す。	Natsuki glances around.	ナツキは辺りを見回す。
Monika isn't in the clubroom.	モニカはいない。	Monika isn't in the clubroom.	モニカはいない。
「Ugh...」	「うう……」	Ugh...	「あれ……」
「Where's Monika, anyway?」	「モニカはどこよ？」	Where's Monika, anyway?	「モニカはどこよ？」
「Good question...」	「さあ……」	Good question...	「さあ……」
「Have any of you heard anything about her being late today?」	「誰か、モニカちゃんが今日は遅れるということを聞いていますか？」	Have any of you heard anything about her being late today?	「誰か今日、モニカちゃんが遅れるって聞いていますか？」
「Not me...」	「聞いてないよ……」	Not me...	「聞いてないよ……」
「Yeah, I haven't either.」	「俺も聞いてないな」	Yeah, I haven't either.	「俺も聞いてないな」
「Hm...」	「うーん……」	Hm...	「あら……」
「That's a bit unusual.」	「珍しいですね」	That's a bit unusual.	「珍しいですね」
「I hope she's okay...」	「大丈夫だといいけど……」	I hope she's okay...	「大丈夫だといいけど……」
「Of course she's okay.」	「大丈夫に決まってるじゃない」	Of course she's okay.	「大丈夫に決まってるじゃない」
「She probably just had something to do today.」	「ただ何か用事でもあるんでしょ」	She probably just had something to do today.	「ただ何か用事でもあるんでしょ」
「She's pretty popular, after all...」	「なんてったって人気者だしね……」	She's pretty popular, after all...	「何てったって人気者だしね……」
「Eh?」	「え？」	Eh?	「はっ？」
「You don't think she...」	「それってつまり……」	You don't think she...	「それってつまり……」
「She has a...!」	「モニカちゃんにそういう人がいるの！？」	She has a...!	「モニカちゃんにそういう人がいるの！？」
「Ahaha. I wouldn't be surprised.」	「うふふ。だとしても特に驚きはありませんが」	Ahaha. I wouldn't be surprised.	「うふふ。だとしても特に驚きはありませんが」
「She's probably more desirable than all of us combined.」	「私たち全員が束になっても敵わないぐらい魅力的ですから」	She's probably more desirable than all of us combined.	「私たち全員が束になっても敵わないぐらい魅力的ですから」
「Ehehe, that's true...」	「えへへ、そうだね……」	Ehehe, that's true...	「えへへ、そうだね……」
「Excuse me?!」	「なんですってえ！？」	Excuse me?!	「何ですってえ！？」
Suddenly, the door swings open.	突然ドアが開け放たれた。	Suddenly, the door swings open.	突然ドアが開け放たれた。
「Sorry! I'm super sorry!」	「ごめん！ 本当にごめんなさい！」	Sorry! I'm super sorry!	「ごめん！ 本当にごめんなさい！」
「Ah, there you are...」	「お、来たな……」	Ah, there you are...	「お、来たな……」
「I didn't mean to be late...」	「遅れるつもりはなかったの……」	I didn't mean to be late...	「遅れるつもりはなかったの……」
「I hope you guys weren't worried or anything!」	「心配かけちゃったかしら！」	I hope you guys weren't worried or anything!	「心配かけちゃったかしら！」
「Eh??」	「おお？」	Eh??	「あれ？？」
「Monika chose the club over her boyfriend after all!」	「モニカちゃんが彼氏より部活を取った！」	Monika chose the club over her boyfriend after all!	「モニカちゃんが彼氏より部活を取った！」
「You're so strong-willed!」	「気合入ってる～！」	You're so strong-willed!	「気合入ってる～！」
「B-Boyfriend...?」	「か、彼氏……？」	B-Boyfriend...?	「か、彼氏……？」
「What on Earth are you talking about?」	「一体何のことを言ってるのよ？」	What on Earth are you talking about?	「一体何の話？」
Monika quizzically glances at me.	モニカは困った様子で俺を見る。	Monika quizzically glances at me.	モニカは困った様子で俺を見る。
「Ah, never mind that...」	「いや、気にしないでくれ……」	Ah, never mind that...	「いや、気にしなくていいよ……」
「What held you up, anyway?」	「ところで、何かあったのか？」	What held you up, anyway?	「ところで、何かあったのか？」
「Ah...」	「ああ……」	Ah...	「あのね……」
「Well, my last period today was study hall.」	「最後の授業が自習だったから」	Well, my last period today was study hall.	「最後の授業が自習だったから」
「To be honest, I kind of just lost track of time...」	「時間のことをちょっと忘れちゃってて……」	To be honest, I kind of just lost track of time...	「時間のことをちょっと忘れちゃってて……」
「Ahaha...」	「あはは……」	Ahaha...	「そうだな……」
「That makes no sense, though.」	「それにしたって納得はできないんだけど」	That makes no sense, though.	「それにしたって納得できないんだけど」
「You would have heard the bell ring, at least.」	「チャイムの音ぐらいは聞こえたはずでしょ？」	You would have heard the bell ring, at least.	「チャイムの音ぐらいは聞こえたはずでしょ？」
「I must not have heard it, since I was practicing piano...」	「ピアノの練習をしてたから、全然聞こえなくて……」	I must not have heard it, since I was practicing piano...	「ピアノの練習をしてたから、全然聞こえなくて……」
「Piano...?」	「ピアノ……？」	Piano...?	「ピアノ……？」
「I wasn't aware you played music as well, Monika.」	「モニカちゃんが音楽も上手だなんて知りませんでした」	I wasn't aware you played music as well, Monika.	「モニカちゃんが音楽もできるだなんて知りませんでした」
「Ah, I don't, really...!」	「いや、そうじゃなくて……」	Ah, I don't, really...!	「いや、そうじゃなくて……」
「I kind of just started recently.」	「最近始めたばかりなの」	I kind of just started recently.	「最近始めたばかりなの」
「I've always wanted to learn piano.」	「ずっとピアノをやってみたいと思ってたから」	I've always wanted to learn piano.	「ずっとピアノをやってみたいと思ってたから」
「That's so cool!」	「すごーい！」	That's so cool!	「すごーい！」
「You should play something for us, Monika!」	「何か弾いてみてよ、モニカちゃん！」	You should play something for us, Monika!	「何か弾いてみてよ、モニカちゃん！」
「That's...」	「それは……」	That's...	「それは……」
Monika looks at me.	モニカは俺を見る。	Monika looks at me.	モニカは俺を見る。
「Maybe once I get a little bit better, I will.」	「もう少し上手くなったら、ね」	Maybe once I get a little bit better, I will.	「もう少しうまくなったら、ね」
「Yay~!」	「やった～！」	Yay~!	「やった～！」
「That sounds cool.」	「それはすごいな」	That sounds cool.	「それはすごいな」
「I'd also look forward to it.」	「俺も楽しみにしてるよ」	I'd also look forward to it.	「俺も楽しみにしてるよ」
「Is that so?」	「そう？」	Is that so?	「ホントに？」
「In that case...」	「だったら……」	In that case...	「そういうことなら……」
「I won't let you down, [player].」	「[player]君をがっかりさせないためにも頑張らなきゃ」	I won't let you down, [player].	「[player]君をがっかりさせないためにも、がんばらなきゃ」
Monika smiles sweetly.	モニカは優しくほほ笑む。	Monika smiles sweetly.	モニカは優しく微笑む。
「Ah...」	「あ……」	Ah...	「ああ……」
「I didn't mean any pressure or anything like that!」	「別にプレッシャーかけようとか、そういうつもりじゃないんだ！」	I didn't mean any pressure or anything like that!	「別にプレッシャーかけようとか、そういうつもりじゃないぞ」
「Ahaha, don't worry.」	「あはは、心配しないで」	Ahaha, don't worry.	「あははっ、心配しないで」
「I've been practicing a whole lot recently.」	「最近たくさん練習してるから」	I've been practicing a whole lot recently.	「最近たくさん練習してるから」
「And I'd really love the chance to share once I'm ready.」	「それに、私も準備ができたら披露してみたいと思ってるし」	And I'd really love the chance to share once I'm ready.	「それに、私も準備ができたら披露してみたいと思ってるし」
「I see...」	「そうか……」	I see...	「そうなのか……」
「In that case, best of luck.」	「そういうことなら、頑張ってくれ」	In that case, best of luck.	「それなら、がんばってくれ」
「Thanks~!」	「ありがとう！」	Thanks~!	「ありがとう！」
「So, I didn't miss anything, did I?」	「それで、私のいない間に何かあった？」	So, I didn't miss anything, did I?	「それで、私のいない間に何かあった？」
「Not...not really.」	「いや……何も」	Not...not really.	「いや……何も」
I choose to leave out Sayori's mischievous escapade.	サヨリの突飛な行動については何も言わないことにした。	I choose to leave out Sayori's mischievous escapade.	サヨリの突飛な行動については何も言わないことにした。
I'm sure Natsuki will end up complaining to her, anyway.	きっと後でナツキがモニカに言いつけるだろう。	I'm sure Natsuki will end up complaining to her, anyway.	きっと後でナツキがモニカに言いつけるだろう。
It looks like everyone has already settled down.	みんなの様子もそろそろ落ち着いてきたようだ。	It looks like everyone has already settled down.	みんなもすっかりひと段落したようだ。
Sayori somehow already finished her entire cookie.	サヨリはクッキーを完食してしまっている。	Sayori somehow already finished her entire cookie.	サヨリはクッキーを完食してしまっているし……
Yuri is back to her book, and Natsuki disappeared into the closet.	ユリは本へと舞い戻り、ナツキはクローゼットへと消えている。	Yuri is back to her book, and Natsuki disappeared into the closet.	ユリは本へと舞い戻り、ナツキは物置へと消えている。
