Another day passes, and it's time for the club meeting already.	一日が過ぎ、部活の時間がやってきた。	Another day passes, and it's time for the club meeting already.	一日が過ぎ、部活の時間がやってきた。
I've gotten a little more comfortable here over the past couple days.	ここ数日でいくらかこの場所も居心地が良くなってきたように思う。	I've gotten a little more comfortable here over the past couple days.	ここ数日で、いくらかこの場所も居心地が良くなってきたように思う。
Entering the clubroom, the usual scene greets me.	部室に入ると、いつもの光景が俺を出迎えてくれる。	Entering the clubroom, the usual scene greets me.	部室に入ると、いつもの光景が俺を出迎えてくれる。
「Welcome back, [player]...」	「こんにちは、[player]さん……」	Welcome back, [player]...	「こんにちは、[player]さん……」
「Ah, hi Yuri...」	「あ、よお、ユリ……」	Ah, hi Yuri...	「あ、よお、ユリ……」
I'm not sure if it's me, or if it's Yuri's expression...	俺の気のせいなのかもしれないが、ユリの表情からして……	I'm not sure if it's me, or if it's Yuri's expression...	俺の気のせいなのかもしれないが、ユリの表情からして……
But the weight of yesterday's quarrel still hangs in the air a little.	昨日の口論の重苦しい空気は残ったままだ。	But the weight of yesterday's quarrel still hangs in the air a little.	昨日の口論の重苦しい空気は残ったままだ。
「U-Um...」	「え、えっと……」	U-Um...	「その……」
Yuri glances over her shoulder, looking around the room.	ユリは肩越しに部屋の中を見渡す。	Yuri glances over her shoulder, looking around the room.	ユリは肩越しに部屋の中を見渡す。
Natsuki is reading manga at a desk.	ナツキは机でマンガを読んでいる。	Natsuki is reading manga at a desk.	ナツキは机でマンガを読んでいる。
And surprisingly, Monika isn't here yet.	そして驚くべきことに、モニカはまだ来ていない。	And surprisingly, Monika isn't here yet.	そして驚くべきことに、モニカはまだ来ていない。
Suddenly, Yuri takes my arm and pulls me to the corner of the room.	すると、急にユリに腕を引かれ部屋の隅へと連れていかれる。	Suddenly, Yuri takes my arm and pulls me to the corner of the room.	すると、急にユリに腕を引かれ部屋の隅へと連れていかれる。
「About yesterday...」	「昨日のことなんですが……」	About yesterday...	「昨日のことなんですが……」
「I...」	「私……」	I...	「アタシは……」
「I really need to apologize.」	「私、謝らないといけません」	I really need to apologize.	「私、謝らないといけません」
「Nothing like that has ever happened before...」	「あんなこと、今まで無かったんですが……」	Nothing like that has ever happened before...	「あんなこと、今までなかったんですが……」
「And...something just came over me, I guess...」	「何かに支配されたような感じで……」	And...something just came over me, I guess...	「何かに支配されたような感じで……」
「I wasn't acting mentally sound.」	「どうかしていたんです」	I wasn't acting mentally sound.	「どうかしていたんです」
「Please don't think we're usually like this!」	「私たちがいつもあんな風だとは思わないでください！」	Please don't think we're usually like this!	「私たちがいつもあんな風だとは思わないでください！」
「Not just me, but Natsuki as well...」	「私だけのことではなく、ナツキちゃんについても……」	Not just me, but Natsuki as well...	「私だけのことではなく、ナツキちゃんについても……」
「Yuri...」	「ユリ……」	Yuri...	「ユリ……」
「I'm happy that you were considerate and apologized.」	「ユリが丁寧に謝ってくれて、嬉しいよ」	I'm happy that you were considerate and apologized.	「ユリが丁寧に謝ってくれて、うれしいよ」
「You don't have to worry too much.」	「そんなに心配しなくても大丈夫だ」	You don't have to worry too much.	「そんなに心配しなくても大丈夫だ」
「Even though I've only been here a couple days, I could tell something was off yesterday...」	「まだ俺は入部して少ししか経ってないが、それでも昨日は何かがおかしかったっていうのは分かる……」	Even though I've only been here a couple days, I could tell something was off yesterday...	「俺はまだ入部して少ししか経ってないけど、それでも昨日は何かおかしかったっていうのはわかる……」
「Maybe we were just a little extra sensitive because it was our first time sharing poems.」	「詩を見せ合うなんて初めてのことだったから、みんなちょっと神経質になってたんだろう」	Maybe we were just a little extra sensitive because it was our first time sharing poems.	「詩を見せ合うなんて初めてのことだったから、みんなちょっと神経質になってたんだろう」
「But whatever it was...」	「何にせよ……」	But whatever it was...	「何にせよ……」
「It didn't make me think any less of you.」	「それでユリのことを嫌いになったりはしていない」	It didn't make me think any less of you.	「それでユリのことを嫌いになったりはしてない」
「I had already decided that there's no way you can be a bad person.」	「もう俺はユリが悪い奴じゃないって確信を持ってるんだ」	I had already decided that there's no way you can be a bad person.	「もう、俺はユリが絶対に悪いヤツじゃないって信じてる」
「And now that you're apologizing, I know you really didn't mean it.」	「謝ってもくれたし、本当にそんなつもりじゃなかったんだってことがよく分かった」	And now that you're apologizing, I know you really didn't mean it.	「謝ってもくれたし、本当にそんなつもりじゃなかったんだって、よくわかった」
「A-Ah...」	「ああ……」	A-Ah...	「う、うん……」
「[player]...」	「[player]さん……」	[player]...	「[player]……」
「Don't say those kinds of things so frankly...」	「そう言って頂けるなんて……」	Don't say those kinds of things so frankly...	「そう言っていただけるなんて……」
「They make me a little too happy.」	「とても嬉しいです」	They make me a little too happy.	「とてもうれしいです」
「I'm really glad that you're such an understanding person...」	「あなたが理解ある方で本当によかったです……」	I'm really glad that you're such an understanding person...	「あなたが理解ある方で本当によかったです……」
「And I'm really glad that you joined this club.」	「それに、あなたが入部してくれたこともすごく嬉しいんです」	And I'm really glad that you joined this club.	「それに、あなたが入部してくれたこともすごくうれしいんです」
「Everything is a little bit brighter with you around, and--」	「あなたがいるだけで世界が明るくなって――」	Everything is a little bit brighter with you around, and--	「あなたがいるだけで世界が明るくなって――」
「Ah--」	「あ――」	Ah--	「えっと……」
「Sorry, what am I saying right now...?」	「ごめんなさい、私おかしなことを言ってましたか……？」	Sorry, what am I saying right now...?	「ごめんなさい、私、おかしなことを言ってしまいましたか……？」
「I just--」	「私はただ――」	I just--	「ただ――」
「Hey, have you guys seen Monika?」	「ねえ、モニカ見なかった？」	Hey, have you guys seen Monika?	「ねえ、モニカ見なかった？」
「Ah--!」	「あ――！」	Ah--!	「あ――！」
「No, I haven't...」	「いや、見てないな……」	No, I haven't...	「いや、見てないな……」
「I was also kind of wondering where she was.」	「俺もどこにいるのかと思ってたんだが」	I was also kind of wondering where she was.	「俺もどこにいるのかと思ってたんだが」
「Man...」	「そう……」	Man...	「ったく……」
「Yuri, I'm guessing you haven't, either?」	「あんたも知らないんでしょ、ユリ？」	Yuri, I'm guessing you haven't, either?	「アンタも知らないんでしょ、ユリ？」
「...」	「……」	...	「……」
Yuri is clearly taken aback by how calmly Natsuki is addressing her.	ユリはナツキのあまりにも平然とした態度に呆気に取られてしまっている。	Yuri is clearly taken aback by how calmly Natsuki is addressing her.	ユリはナツキのあまりにも平然とした態度に、呆気に取られてしまっている。
「N-No, I haven't...」	「し、知りません……」	N-No, I haven't...	「し、知りません……」
「Jeez, this isn't like her at all.」	「全く、モニカにしては珍しいわね」	Jeez, this isn't like her at all.	「まったく、モニカにしては珍しいわね」
「I know it's stupid, but I can't help but worry a little bit...」	「まさかとは思うけど、少し心配になってくるじゃない……」	I know it's stupid, but I can't help but worry a little bit...	「まさかとは思うけど、少し心配になってくるじゃない……」
「...」	「……」	...	「……」
「What?」	「何？」	What?	「何ですって？」
「Why're you looking at me like that?」	「何でそんなにこっち見てるのよ？」	Why're you looking at me like that?	「何でそんなにこっち見てるのよ？」
「U-Um...」	「あ、あの……」	U-Um...	「ちょ、ちょっと……」
「Natsuki, about yesterday...」	「ナツキちゃん、昨日のこと……」	Natsuki, about yesterday...	「ナツキちゃん、昨日のこと……」
「I-I just wanted to apologize!」	「わ、私、謝りたくて！」	I-I just wanted to apologize!	「わ、私、謝りたくて！」
「I promise I didn't mean any of the things I said!」	「私が口走ってしまったことは全部、本心なんかではないんです！」	I promise I didn't mean any of the things I said!	「私が口走ってしまったことは全部、本心なんかではないんです！」
「And I'll do my best to stay under control from now on...」	「今後は自分自身をコントロールできるように努力もしますし……」	And I'll do my best to stay under control from now on...	「今後は自分自身をコントロールできるように努力もしますし……」
「So--」	「だから……」	So--	「だから……」
「Yuri, what the heck are you talking about?」	「ユリ、あんた何の話してるの？」	Yuri, what the heck are you talking about?	「ユリ、アンタ何の話してるの？」
「Did you do something yesterday?」	「昨日あんた何かしたっけ？」	Did you do something yesterday?	「昨日アンタ何かしたっけ？」
「...Eh?」	「……え？」	...Eh?	「……えっ？」
「Jeez...」	「もう……」	Jeez...	「はあ……」
「Whatever's on your mind, I'm sure it was nothing.」	「あんたがどう思おうと、何も無かったわよ」	Whatever's on your mind, I'm sure it was nothing.	「アンタがどう思おうと、何もなかったわよ」
「I don't even remember anything bad happening.」	「わたしには何か悪いことがあったなんて記憶は無いし」	I don't even remember anything bad happening.	「わたしには何か悪いことがあったなんて記憶はないし」
「You're the kind of person who worries too much about the little things, aren't you?」	「あんたは小さなことを気にしすぎるタイプだもんね」	You're the kind of person who worries too much about the little things, aren't you?	「アンタは小さなことを気にしすぎるタイプだもんね」
「...」	「……」	...	「……」
「B-But...」	「で、でも……」	B-But...	「そ、そっか……」
「mibulls sailcloth blindsight lifeline anan rectipetality faultlessly offered scleromalacia neighed catholicate」	「ミブル　帆布　盲視　生命線　不尽　レクチペタリティ　欠点なく　提供された　強膜軟化症　嘶いた　カトリコスの管轄区」	mibulls sailcloth blindsight lifeline anan rectipetality faultlessly offered scleromalacia neighed catholicate	「ミブル 帆布 盲視 生命線 不尽 レクチペタリティ 欠点なく 提供された 強膜軟化症 嘶いた カトリコスの管轄区」
「I'll accept your apology anyway, if it helps you feel better about it.」	「まあ、それであんたの気が済むならその謝罪とやらを受け入れないでもないけど」	I'll accept your apology anyway, if it helps you feel better about it.	「まあ、それでアンタの気が済むなら、その謝罪とやらを受け入れないでもないけど」
「Besides, it's kinda nice to hear, since I was always afraid you secretly hated me or something like that.」	「それに、今までずっと嫌われてたんじゃないかって不安だったから、そういうことが聞けてよかったわ」	Besides, it's kinda nice to hear, since I was always afraid you secretly hated me or something like that.	「それに、今までずっと嫌われてたんじゃないかって不安だったから、そういうことが聞けてよかったわ」
「Ehehe.」	「えへへ」	Ehehe.	「えへへ」
「N-No, not at all...!」	「は、はい、本当に…！」	N-No, not at all...!	「は、はい、本当に…！」
「I don't hate you...」	「あなたのこと、嫌ってなんかいません……」	I don't hate you...	「あなたのこと、嫌ってなんかいません……」
「Ahaha.」	「あはは」	Ahaha.	「あははっ」
「Well, you're kind of weird, but I don't hate you either.」	「まあ、あんたもちょっと変わってるとこあるけど、わたしもあんたのこと嫌いじゃないわよ」	Well, you're kind of weird, but I don't hate you either.	「まあ、アンタはちょっと変わってるとこあるけど、アタシもアンタのこと嫌いじゃないわよ」
「...」	「……」	...	「……」
Natsuki turns to me.	ナツキは俺の方へ向き直る。	Natsuki turns to me.	ナツキは俺の方へ向き直る。
「You're still on trial, though.」	「あんたはまだ信用ならないけどね」	You're still on trial, though.	「アンタはまだ信用ならないけどね」
「Hey...!」	「おいおい……！」	Hey...!	「おいおい……！」
Suddenly, the door swings open.	突然ドアが開け放たれた。	Suddenly, the door swings open.	突然ドアが開け放たれた。
「Sorry! I'm super sorry!」	「ごめん！ 本当にごめんなさい！」	Sorry! I'm super sorry!	「ごめん！ 本当にごめんなさい！」
「Ah, there you are...」	「お、来たな……」	Ah, there you are...	「お、来たな……」
「I didn't mean to be late...」	「遅れるつもりはなかったの……」	I didn't mean to be late...	「遅れるつもりはなかったの……」
「I hope you guys weren't worried or anything!」	「心配かけちゃったかしら！」	I hope you guys weren't worried or anything!	「心配かけちゃったかしら！」
「Nah...」	「いや……」	Nah...	「いや……」
「Well, Natsuki was.」	「まあ、ナツキは心配してたけど」	Well, Natsuki was.	「まあ、ナツキは心配してたけど」
「I-I was not!!」	「し、してないわよ！」	I-I was not!!	「し、してないわよ！」
「Ahaha.」	「あはは」	Ahaha.	「あはは」
「...What took you so long, anyway?」	「……ところで、どうしてこんなに遅れたのよ？」	...What took you so long, anyway?	「……ところで、どうしてこんなに遅れたのよ？」
「Ah...」	「ああ……」	Ah...	「あのね……」
「Well, my last period today was study hall.」	「最後の授業が自習だったから」	Well, my last period today was study hall.	「最後の授業が自習だったから」
「To be honest, I kind of just lost track of time...」	「時間のことをちょっと忘れちゃってて……」	To be honest, I kind of just lost track of time...	「時間のことをちょっと忘れちゃってて……」
「Ahaha...」	「あはは……」	Ahaha...	「そうだな……」
「That makes no sense, though.」	「それにしたって納得はできないんだけど」	That makes no sense, though.	「それにしたって納得できないんだけど」
「You would have heard the bell ring, at least.」	「チャイムの音ぐらいは聞こえたはずでしょ？」	You would have heard the bell ring, at least.	「チャイムの音ぐらいは聞こえたはずでしょ？」
「I must not have heard it, since I was practicing piano...」	「ピアノの練習をしてたから、全然聞こえなくて……」	I must not have heard it, since I was practicing piano...	「ピアノの練習をしてたから、全然聞こえなくて……」
「Piano...?」	「ピアノ……？」	Piano...?	「ピアノ……？」
「I wasn't aware you played music as well, Monika.」	「モニカちゃんが音楽も上手だなんて知りませんでした」	I wasn't aware you played music as well, Monika.	「モニカちゃんが音楽もできるだなんて知りませんでした」
「Ah, don't give me more credit than I deserve.」	「そんな、大げさよ……」	Ah, don't give me more credit than I deserve.	「そんな、大げさよ……」
「I guess I've been practicing for a while, but I'm still not really good yet.」	「しばらく練習はしてるけど、本当にまだ大したものじゃないから」	I guess I've been practicing for a while, but I'm still not really good yet.	「しばらく練習はしてるけど、本当にまだ大したものじゃないから」
「Still...」	「だとしても……」	Still...	「だとしても……」
「That must require a lot of dedication.」	「それはひたむきな熱意が無ければできないことです」	That must require a lot of dedication.	「それはひたむきな熱意がなければできないことです」
「So, I'm still impressed.」	「その情熱には心を打たれます」	So, I'm still impressed.	「その情熱には心を打たれます」
「Aw, well thanks, Yuri~」	「ふふ、なんだかありがとう、ユリ」	Aw, well thanks, Yuri~	「ふふ、何だかありがとう、ユリ」
「You should play something for us sometime!」	「そのうち何か弾いてみなさいよ！」	You should play something for us sometime!	「そのうち何か弾いてみなさいよ！」
「Ahaha, that's...」	「あはは、それは……」	Ahaha, that's...	「あはは、それは……」
Monika looks at me.	モニカは俺を見る。	Monika looks at me.	モニカは俺を見る。
「Well, I am working on writing a song, but it's not quite done yet...」	「えっと、今作曲もしてるんだけど、それもまだ出来てないし……」	Well, I am working on writing a song, but it's not quite done yet...	「えっと、今作曲もしてるんだけど、それもまだできてないし……」
「Maybe once I get a little bit better, I will.」	「もう少し上手くなったら、ね」	Maybe once I get a little bit better, I will.	「もう少しうまくなったら、ね」
「That sounds cool.」	「それはすごいな」	That sounds cool.	「それはすごいな」
「I look forward to it.」	「楽しみにしてるよ」	I look forward to it.	「楽しみにしています」,Must
「Is that so?」	「そう？」	Is that so?	「ホントに？」
「In that case...」	「だったら……」	In that case...	「そういうことなら……」
「I won't let you down, [player].」	「[player]君をがっかりさせないためにも頑張らなきゃ」	I won't let you down, [player].	「[player]君をがっかりさせないためにも、がんばらなきゃ」
Monika smiles sweetly.	モニカは優しくほほ笑む。	Monika smiles sweetly.	モニカは優しく微笑む。
「Ah...」	「あ……」	Ah...	「ああ……」
「I didn't mean any pressure or anything like that!」	「別にプレッシャーかけようとか、そういうつもりじゃないんだ！」	I didn't mean any pressure or anything like that!	「別にプレッシャーかけようとか、そういうつもりじゃないぞ」
「Ahaha, don't worry.」	「あはは、心配しないで」	Ahaha, don't worry.	「あははっ、心配しないで」
「I was hoping that I could share it with you, anyway.」	「何にせよ[player]君にも披露してみたいとは思っていたし」	I was hoping that I could share it with you, anyway.	「何にせよ披露してみたいって思ってたし」
「I guess that's why I've been practicing so much recently.」	「そういう気持ちのおかげで最近練習を頑張れてるってところもあるもの」	I guess that's why I've been practicing so much recently.	「そういう気持ちのおかげで最近練習をがんばれてるってところもあるもの」
「I see...」	「そうか……」	I see...	「そうか……」
I'm not sure if Monika was referring to the whole club, or just me...	モニカの言う披露したい相手が文芸部全体なのか、それとも俺だけなのかはよくわからないが……	I'm not sure if Monika was referring to the whole club, or just me...	モニカの言う披露したい相手が文芸部全体なのか、それとも俺だけなのかはよくわからないが……
「In that case, best of luck.」	「そういうことなら、頑張ってくれ」	In that case, best of luck.	「それなら、がんばってくれ」
「Thanks~!」	「ありがとう！」	Thanks~!	「ありがとう！」
「So, I didn't miss anything, did I?」	「それで、私のいない間に何かあった？」	So, I didn't miss anything, did I?	「それで、私のいない間に何かあった？」
「Not...not really.」	「いや……何も」	Not...not really.	「いや……何も」
I choose not to bring up anything that the three of us talked about.	俺たち３人が話していたことについては何も言わないことにした。	I choose not to bring up anything that the three of us talked about.	俺たち３人が話していたことについては何も言わないことにした。
Besides, Natsuki has already run off into the closet.	それに、ナツキは既にクローゼットの中へ入って行ってしまっている。	Besides, Natsuki has already run off into the closet.	それに、ナツキはすでに物置にこもってしまっている。
「[player]...」	「[player]さん……」	[player]...	「[player]さん……」
「Um...」	「えっと……」	Um...	「その……」
「Since your compliments put me in a good mood...」	「あなたに褒めて頂けたことで、とても幸せな気分になれたので……」	Since your compliments put me in a good mood...	「あなたに褒めていただけたことで、とても幸せな気分になれたので……」
「I was wondering if you would like to spend some time together today.」	「今日も二人で一緒に過ごすことができれば、と思ったのですが」	I was wondering if you would like to spend some time together today.	「今日も一緒に過ごすことができれば、と思ったのですが」
「I mean--in the club!」	「も、もちろん、部活での話ですよ！」	I mean--in the club!	「も、もちろん、部活での話ですよ！」
「Ah, I suppose so.」	「ああ、そうだな」	Ah, I suppose so.	「ああ、そうだな」
「I don't think I could say no to you, after you gave that book to me.」	「本まで貸してもらったことだし、嫌とは言えないよな」	I don't think I could say no to you, after you gave that book to me.	「本まで貸してもらったことだし、嫌とは言えないよな」
「Well, I guess I need to make sure Natsuki isn't waiting for me.」	「でも、その前にナツキが俺のことを待ってないか確かめないといけないな」	Well, I guess I need to make sure Natsuki isn't waiting for me.	「でも、その前にナツキが俺のことを待ってないか確かめないと」
「After we finished reading yesterday, she--」	「昨日詩を読み終わった後、ナツキが――」	After we finished reading yesterday, she--	「昨日詩を読み終わった後、ナツキが――」
「She's fine!」	「ナツキちゃんは大丈夫です！」	She's fine!	「ナツキちゃんは大丈夫です！」
「She's reading over there. See?」	「向こうで本を読んでますから。ね？」	She's reading over there. See?	「向こうで本を読んでますから。ね？」
「Don't think about her so much.」	「あまりあの子について考えないでください」	Don't think about her so much.	「あの子のことは忘れてください」
「She's used to being ignored.」	「あの子は無視されることに慣れてますから」	She's used to being ignored.	「あの子は、無視されることに慣れてますから」
「Come on, we're going over there.」	「行きましょう、あちらです」	Come on, we're going over there.	「行きましょう、あちらです」
「S-She's fine!」	「ナ、ナツキちゃんは大丈夫です！」	S-She's fine!	「ナ、ナツキちゃんは大丈夫です！」
「She's reading over there.」	「向こうで本を読んでますから」	She's reading over there.	「向こうで本を読んでますから」
「So it's okay, right?」	「だから問題ありませんよね？」	So it's okay, right?	「だから問題ありませんよね？」
「Ah--」	「ああ……」	Ah--	「えっと……」
「In that case, I don't see any problem...」	「それなら、何も問題は無いな……」	In that case, I don't see any problem...	「それなら、何も問題はないな……」
「Yeah, definitely.」	「うん、そうだな」	Yeah, definitely.	「うん、そうだな」
「I planned on it anyway.」	「いずれにしろ、俺もそう思ってたんだ」	I planned on it anyway.	「俺もそう思ってたんだ」
「Okay!」	「そうですか！」	Okay!	「そうだ！」
「Can we start now?」	「それでは始めましょう」	Can we start now?	「それでは始めましょう」
「Let's find a place to sit--」	「座る場所を――」	Let's find a place to sit--	「座る場所を――」
「A-Ah--」	「あっ――」	A-Ah--	「あ、あっ……」
「I'm being a little forceful, aren't I...?」	「私、強引でしたか……？」	I'm being a little forceful, aren't I...?	「私、強引でしたか……？」
「I'm sorry!」	「すみません！」	I'm sorry!	「すみません！」
「My heart...just won't stop pounding, for some reason...」	「何故か……胸の高鳴りが、収まらないのです……」	My heart...just won't stop pounding, for some reason...	「何故か……胸の高鳴りが、収まらないんです……」
「Don't worry about it.」	「気にしないでくれ」	Don't worry about it.	「気にしないでくれ」
「If anything, it's nice to see you have so much energy.」	「何にせよ、活発なのはいいことだ」	If anything, it's nice to see you have so much energy.	「何にせよ、活発なのはいいことだ」
「Y-Yeah!」	「は、はい！」	Y-Yeah!	「は、はい！」
「But...」	「しかし……」	But...	「けど……」
「I need to try to calm down.」	「落ち着かなければいけません」	I need to try to calm down.	「落ち着かなければいけません」
「I won't be able to focus on reading like this...」	「こんな状態では読むことに集中できませんから……」	I won't be able to focus on reading like this...	「こんな状態では読むことに集中できませんから……」
「Take your time.」	「焦らなくてもいいぞ」	Take your time.	「焦らなくてもいいぞ」
Yuri takes a deep breath, then pulls a copy of the book out of her bag.	ユリは深呼吸をしてから、本をカバンから引っ張り出した。	Yuri takes a deep breath, then pulls a copy of the book out of her bag.	ユリは深呼吸をしてから、本をカバンから引っ張り出した。
