Man...	はあ……	Man...	「ったく……」
It looks like no one wants to be bothered today.	今日はみんな取り込み中のようだ。	It looks like no one wants to be bothered today.	今日はみんな取り込み中のようだ。
I slump down into the nearest desk.	俺は近くの机にドサッと座り込んだ。	I slump down into the nearest desk.	俺は近くの席にドカッと座り込んだ。
How am I supposed to occupy myself with something literature-related by myself like this?	一人でどうやって文学関係のことをすればいいんだ？	How am I supposed to occupy myself with something literature-related by myself like this?	一人でどうやって文芸部っぽいことをすればいいんだ？
I guess I could always read some of the book Yuri gave me...	ユリに貰った本でも読んでみるか……	I guess I could always read some of the book Yuri gave me...	ユリにもらった本でも読んでみるか……
...But I'm feeling a little too tired to read.	……やっぱり今は読書するには眠すぎる。	...But I'm feeling a little too tired to read.	……やっぱり今は読書するには眠すぎる。
I could probably fall asleep right now.	今にも寝てしまいそうだ。	I could probably fall asleep right now.	今にも寝てしまいそうだ。
I close my eyes and end up listening in on Sayori's conversation with Monika.	目を閉じると耳に入ってきたサヨリとモニカの会話を聞く。	I close my eyes and end up listening in on Sayori's conversation with Monika.	目を閉じるとサヨリとモニカの会話が耳に入ってきた。
「We're probably gonna seem really lame compared to all the other clubs, though...」	「でも他の部活と比べてダサいって思われちゃうかも……」	We're probably gonna seem really lame compared to all the other clubs, though...	「でも他の部活と比べてダサいって思われちゃうかも……」
「Hmm...」	「そうね……」	Hmm...	「ふーん……」
「Well, we can't give up.」	「でも、諦める訳にはいかないわよね」	Well, we can't give up.	「でも、諦めるわけにはいかないわよね」
「The festival is our chance to show everyone what literature is all about!」	「文化祭はみんなに文学の魅力を伝えるチャンスだもの！」	The festival is our chance to show everyone what literature is all about!	「文化祭はみんなに文学の魅力を伝えるチャンスだもの！」
「The problem is that the idea of a literature club sounds too dense and intellectual...」	「問題は文芸部って真面目で堅苦しいイメージがあること……」	The problem is that the idea of a literature club sounds too dense and intellectual...	「問題は文芸部って真面目で堅苦しいイメージがあること……」
「But it's not like that at all, you know?」	「全然そんなことないのにね？」	But it's not like that at all, you know?	「全然そんなことないのにね？」
「We just need a way of showing that to everyone...」	「それをみんなに伝える方法があれば……」	We just need a way of showing that to everyone...	「それをみんなに伝える方法があれば……」
「Something that speaks to their creative minds.」	「みんなの創造性を刺激する何かが……」	Something that speaks to their creative minds.	「みんなの創造性を刺激する何かが……」
「Mmmmmmmmmmm.....」	「う～～～～ん……」	Mmmmmmmmmmm.....	「う～～～～ん……」
「That doesn't solve the problem, though!」	「でもそれって問題解決になってないと思う！」	That doesn't solve the problem, though!	「でもそれって問題解決になってないと思う！」
「Eh? What do you mean?」	「えっ？ どういうこと？」	Eh? What do you mean?	「え？ どしたの？」
「Even if we come up with the most fun thing ever...」	「わたしたちがたとえどんなに楽しいことを思いついても……」	Even if we come up with the most fun thing ever...	「わたしたちが例えどんなに楽しいことを思いついても……」
「Nobody will come in the first place if it's a literature event.」	「文学関係の出し物だって聞いたらみんな来てくれないと思うんだ」	Nobody will come in the first place if it's a literature event.	「文学関係の出し物だって聞いたらみんな来てくれないと思うんだ」
「So it's more important to figure out how to get people to show up in the first place, you know?」	「だからまずは人を呼び込む方法を考えた方がいいんじゃないかな？」	So it's more important to figure out how to get people to show up in the first place, you know?	「だからまずは人を呼び込む方法を考えた方がいいんじゃないかな？」
「And after they come, we can do the thing to speak to their creative minds.」	「来てくれてから、創造性を刺激することをすればいいんだよ」	And after they come, we can do the thing to speak to their creative minds.	「来てもらって、それから創造性を刺激すればいいんだよ」
...What's this?	……なんだ？	...What's this?	……なんだ？
Sayori is taking this really seriously.	サヨリがやけに真剣だ。	Sayori is taking this really seriously.	サヨリがやけに真剣だ。
It's rare to hear her deliberating like this.	こうやって思考を巡らせている様子は珍しい。	It's rare to hear her deliberating like this.	こうやって思考を巡らせている様子は珍しい。
「Huh, that's a good point...」	「なるほど、それは一理あるわね……」	Huh, that's a good point...	「なるほど、それは一理あるわね……」
「In that case, do you think food will do the trick?」	「それなら、食べ物はどうかしら？」	In that case, do you think food will do the trick?	「それなら、食べ物はどうかしら？」
「W-What kind?!」	「ど、どんな！？」	W-What kind?!	「ど、どんな！？」
「Ah... Well, I guess we could--」	「えっ……まあ、例えばだけど――」	Ah... Well, I guess we could--	「えっ……まあ、例えばだけど――」
「Cupcakes!」	「カップケーキ！」	Cupcakes!	「カップケーキ！」
「Ahaha. Good thinking.」	「あははっ、それはいい案ね」	Ahaha. Good thinking.	「あははっ、それはいい案ね」
「Natsuki would love to do that.」	「ナツキもきっと喜んでやってくれるわ」	Natsuki would love to do that.	「ナツキもきっと喜んでやってくれるわ」
「Ah! You're right!」	「だね！」	Ah! You're right!	「だね！」
「Natsuki makes the best cupcakes!」	「ナツキちゃんのカップケーキは最高だもん！」	Natsuki makes the best cupcakes!	「ナツキちゃんのカップケーキは最高だもん！」
「That works out perfectly~」	「これで完璧～」	That works out perfectly~	「これで完璧～」
「That wasn't why you suggested it...?」	「まさかそのために提案したの……？」	That wasn't why you suggested it...?	「まさかそのために提案したの……？」
「Cupcakes speak to my creative tummy~」	「カップケーキはわたしの胃袋の創造性を刺激するのだ～」	Cupcakes speak to my creative tummy~	「カップケーキはわたしの胃袋の創造性を刺激するのだ～」
「...」	「……」	...	「……」
「Cupcakes it is, then.」	「じゃあ、カップケーキで決まりね」	Cupcakes it is, then.	「じゃあ、カップケーキで決まりね」
「I'm hungry...」	「おなかすいた……」	I'm hungry...	「おなかすいた……」
「Anyway, we still need to work out the details of the event itself...」	「さて、次に出し物そのものについてだけど……」	Anyway, we still need to work out the details of the event itself...	「さて、次に出し物そのものについてだけど……」
I find myself smiling.	自然と笑顔になっている自分がいる。	I find myself smiling.	自然と笑顔になっていた。
In the end, Sayori is still her usual self.	やっぱりサヨリはいつも通りだ。	In the end, Sayori is still her usual self.	やっぱりサヨリはいつも通りだ。
But therein lies the unexpected reason I admire her.	だがそこに、自分でも意外なサヨリを尊敬する理由がある。	But therein lies the unexpected reason I admire her.	ここに、俺がサヨリを尊敬する理由がある。
Unlike me, who has trouble finding any motivation at all...	何事においてもやる気のない俺と違って……	Unlike me, who has trouble finding any motivation at all...	何事においてもやる気のない俺と違って……
Sayori can put her mind to things and make them come to life.	サヨリは物事に集中すると、結果を出すことができる。	Sayori can put her mind to things and make them come to life.	サヨリは物事に集中すれば、結果を出せるのだ。
I suppose that's why I end up letting her get on my case about things.	だから俺もあいつのお節介を許しているのだろう。	I suppose that's why I end up letting her get on my case about things.	だから俺もあいつのお節介を許しているのだろう。
I can't help but wonder what it would be like to see the world through her eyes...	あいつの目から見える世界は一体どんなものなのだろう……	I can't help but wonder what it would be like to see the world through her eyes...	あいつの目から見える世界は一体どんなものなのだろう……
「Uwaa--!」	「うわっ――！」	Uwaa--!	「うわっ――！」
I open my eyes to find Sayori's face filling my vision.	目を開けるとサヨリの顔が視界いっぱいに現れた。	I open my eyes to find Sayori's face filling my vision.	目を開けるとサヨリの顔が視界いっぱいに現れた。
I nearly fall out of my chair.	あまりにびっくりして椅子から滑り落ちそうになる。	I nearly fall out of my chair.	あまりにびっくりして椅子から滑り落ちそうになる。
「Ehehe, sorry~」	「えへへ、ごめんね～」	Ehehe, sorry~	「えへへ、ごめんね～」
「Wait!」	「って！」	Wait!	「待てよ！」
「Actually, I'm not sorry at all!」	「全然ごめんじゃない！」	Actually, I'm not sorry at all!	「って、全然ごめんじゃないし！」
「It's your fault for sleeping like that!」	「こんなところで寝てるのが悪いんだよ！」	It's your fault for sleeping like that!	「こんなところで寝てるのが悪いんだよ！」
「This isn't the napping club!」	「昼寝部じゃないんだよここは！」	This isn't the napping club!	「昼寝部じゃないんだよ、ここは！」
「Does our school have a napping club...?」	「うちの学校に昼寝部はないのか……？」	Does our school have a napping club...?	「うちの学校に昼寝部なんてのもあるのか……？」
「You're staying up late again, aren't you?」	「また夜更かししてたでしょ？」	You're staying up late again, aren't you?	「また夜更かししてたでしょ？」
「Now that you're in a club, you're gonna have less time for anime, you know!」	「部活に入ったからにはアニメを見る時間は必然的に減っちゃうんだから！」	Now that you're in a club, you're gonna have less time for anime, you know!	「部活に入ったからにはアニメを見る時間は必然的に減っちゃうんだから！」
「You'll need to get used to it!」	「ちゃんと合わせてくれなきゃダメだよ！」	You'll need to get used to it!	「ちゃんと合わせてくれなきゃダメだよ！」
「Don't say that so loud...!」	「大声で言うなそれを……！」	Don't say that so loud...!	「大声で言うなそれを……！」
I glance over my shoulder to see if Monika overheard.	今のをモニカに聞かれていないか肩越しに振り返って確認する。	I glance over my shoulder to see if Monika overheard.	今のをモニカに聞かれていないか肩越しに振り返って確認する。
「It's true, though...」	「ほんとのことだし……」	It's true, though...	「ホントのことだし……」
「Yeah...」	「ああ……」	Yeah...	よし……
「I know, I know.」	「分かってる、分かってる」	I know, I know.	「わかってる、わかってる」
「You're always looking out for me, Sayori.」	「サヨリはいつも俺を気にかけてくれてるもんな」	You're always looking out for me, Sayori.	「サヨリはいつも俺を気にかけてくれてるもんな」
「Ehehe~」	「えへへ～」	Ehehe~	「うふふ」
「It's what I do best!」	「わたしが一番得意なことだから！」	It's what I do best!	「わたしが一番得意なことだから！」
「...That's a problem!」	「……それは困る！」	...That's a problem!	「……それは困る！」
「What about you?」	「自分のことはどうなんだよ？」	What about you?	「自分のことはどうなんだよ？」
「You look out for me better than you look out for yourself.」	「自分のことより俺ばかり気にして」	You look out for me better than you look out for yourself.	「俺のことばかり気にして」
「You're still oversleeping every day, aren't you?」	「今も毎日寝過ごしてるんだろ？」	You're still oversleeping every day, aren't you?	「今も毎日寝坊してるんだろ？」
「Eh?」	「えっ？」	Eh?	「えっ？」
「N-Not every day!」	「ま、毎日じゃないもん！」	N-Not every day!	「ま、毎日じゃないもん！」
「That's not very convincing...」	「説得力に欠けるな……」	That's not very convincing...	「説得力に欠けるな……」
「How many days this past week have you gotten up on time?」	「ここ一週間で何回時間通りに起きれたんだ？」	How many days this past week have you gotten up on time?	「この一週間で、時間通りに起きれたのは何回だ？」
「That's...」	「それは……」	That's...	「それは……」
「...It's a secret!」	「……ないしょ！」	...It's a secret!	「……ナイショ！」
「I knew it...」	「やっぱりな……」	I knew it...	「やっぱりな……」
「C'monnnn!」	「なんで～！」	C'monnnn!	「なんで～！」
「At least give me the benefit of the doubt...」	「ちょっとは信じてくれたっていいじゃん……」	At least give me the benefit of the doubt...	「ちょっとは信じてくれたっていいじゃん……」
「I can't even do that.」	「いいや、無理だな」	I can't even do that.	「いいや、無理だな」
「Look, Sayori, it's written all over you.」	「自分をよく見てみろサヨリ、全身に書いてあるぞ」	Look, Sayori, it's written all over you.	「自分をよく見てみろサヨリ、全身に書いてあるぞ」
「Eh...?」	「えっ……？」	Eh...?	「え……？」
Sayori glances around at herself.	サヨリは隅々まで自分を見る。	Sayori glances around at herself.	サヨリは隅々まで自分を見る。
「How is it written all over me?」	「どう全身に書いてあるの？」	How is it written all over me?	「どう全身に書いてあるの？」
「You were clearly in a rush this morning...」	「今朝、明らかに大急ぎで来ただろ……」	You were clearly in a rush this morning...	「今朝、明らかに大急ぎで来ただろ……」
「Look, your hair is sticking out all around here.」	「ほら、髪のこの辺とかボサボサだし」	Look, your hair is sticking out all around here.	「ほら、髪のこの辺とかボサボサだし」
「Ah--」	「あっ――」	Ah--	「えっと……」
I run my fingertips down the side of Sayori's hair, trying to straighten it out.	俺はサヨリの髪を手ぐしで整えようとする。	I run my fingertips down the side of Sayori's hair, trying to straighten it out.	俺はサヨリの髪を手ぐしで整えようとする。
「Man, you really need a brush for this...」	「こりゃブラシがいるな……」	Man, you really need a brush for this...	「こりゃブラシがいるな……」
「My hair is just really hard to get right...」	「わたしの髪、まとまりにくいから……」	My hair is just really hard to get right...	「わたしの髪、まとまりにくいから……」
「I won't fall for that.」	「それには騙されないぞ」	I won't fall for that.	「それには騙されないぞ」
「There's more than just your hair.」	「髪だけじゃない」	There's more than just your hair.	「髪だけじゃない」
「Look, your bow isn't straight, either.」	「ほら、リボンも曲がってるし」	Look, your bow isn't straight, either.	「ほら、リボンも曲がってるし」
「And there's a toothpaste stain on your collar right here.」	「襟のここには歯磨き粉のシミが付いてるし」	And there's a toothpaste stain on your collar right here.	「襟のここには歯磨き粉のシミが付いてるし」
I try to wipe off the stain with my finger.	俺は指でシミを拭おうとする。	I try to wipe off the stain with my finger.	俺は指でシミを拭おうとする。
「B-But nobody would ever notice that...」	「だ、誰も気づかないよそんなの……」	B-But nobody would ever notice that...	「だ、誰も気づかないよ、そんなの……」
「Of course they would.」	「いいや、気づくな」	Of course they would.	「いいや、気づく」
「Nobody's gonna tell you about it because they don't want to embarrass you.」	「お前に恥をかかせないよう、誰も言わないだろうがな」	Nobody's gonna tell you about it because they don't want to embarrass you.	「お前に恥をかかせないよう、誰も言わないだろうがな」
「Fortunately, I really don't care about that.」	「幸い、俺はその辺りは気にしないんでね」	Fortunately, I really don't care about that.	「幸い、俺はその辺りは気にしないんでね」
「Hey, you meanie...」	「もう、いじわる……」	Hey, you meanie...	「もう、イジワル……」
「And you don't even keep your blazer buttoned up.」	「ブレザーのボタンも相変わらず開けっ放しだし」	And you don't even keep your blazer buttoned up.	「ブレザーのボタンも相変わらず開けっ放しだし」
「Seriously, Sayori...」	「まったく、サヨリ……」	Seriously, Sayori...	「まったく、サヨリ……」
「Why do you think you don't have a boyfriend yet?」	「お前、なんで未だに彼氏ができないのか分かってるのか？」	Why do you think you don't have a boyfriend yet?	「お前、何でいまだに彼氏ができないのか、わかってるのか？」
「Eh??」	「えっ？？」	Eh??	「は？？」
「That's <i>super</i> mean!」	「今のはひどすぎるよー！」	That's <i>super</i> mean!	「今のは<i>ひどすぎる</i>よー！」
「Sorry, but you'll thank me later...」	「悪いが後で感謝することになると思うな……」	Sorry, but you'll thank me later...	「悪いが後で感謝することになると思うな……」
I start to button her blazer from the bottom.	ブレザーのボタンを下から留めていってやる。	I start to button her blazer from the bottom.	ブレザーのボタンを下から留めていってやる。
「Once you see how much better it looks, you'll change your mind.」	「これで印象がどれだけ変わるか知ったら、気も変わるよ」	Once you see how much better it looks, you'll change your mind.	「これでどれだけ印象が変わるかを知ったら、気も変わるよ」
「Ehehe~」	「えへへ～」	Ehehe~	「うふふ」
「This is so funny.」	「なんだか変な感じ」	This is so funny.	「何だか変な感じ」
「What is?」	「なにが？」	What is?	「なにが？」
「Well...」	「なんか……」	Well...	「今度は……」
「I was just thinking how weird it is to have a friend who does these kinds of things.」	「こういうことをしてくれる友達がいるのって不思議だなぁ、って」	I was just thinking how weird it is to have a friend who does these kinds of things.	「こういうことをしてくれる友達がいるのって不思議だなぁ、って」
「Eh?」	「は？」	Eh?	「はっ？」
「D-Don't say that!」	「そ、そういうこと言うな！」	D-Don't say that!	「そ、そういうこと言うな！」
「You'll make <i>me</i> feel weird about it, stupid...」	「お、俺まで変な感じになるだろ、バカ……」	You'll make <i>me</i> feel weird about it, stupid...	「お、俺まで<i>変な感じ</i>になるだろ、バカ……」
「It's okay, though.」	「わたしはいいよ」	It's okay, though.	「わたしはいいよ」
「I'm happy we're like this.」	「こういう仲なのが嬉しい」	I'm happy we're like this.	「こういう仲なのが、うれしい」
「Aren't you?」	「そう思わない？」	Aren't you?	「そう思わない？」
「Ah--」	「あー……」	Ah--	「えっと……」
「I-I guess...」	「そ、そうかもな……」	I-I guess...	「そ、そうかもな……」
「Hey, be careful...」	「ねぇ大丈夫……？」	Hey, be careful...	「ねぇ、大丈夫……？」
「The button might come off!」	「そのボタン取れそうじゃない！？」	The button might come off!	「そのボタン、取れそうじゃない！？」
「Why is this one so hard to close...?」	「なんでこのボタンだけ留めにくいんだ……？」	Why is this one so hard to close...?	「何で、このボタンだけ留めにくいんだ……？」
I struggle to fully close the button near her chest.	胸に近いボタンが中々留められず手こずる。	I struggle to fully close the button near her chest.	胸に近いボタンが中々留められず手こずる。
「Does this thing even fit you properly?」	「そもそもこれサイズ合ってるのか？」	Does this thing even fit you properly?	「そもそもこれ、サイズ合ってるのか？」
「Ehehe~」	「えへへ～」	Ehehe~	「えへへ～っ」
「It did when I bought it.」	「買った時は合ってたもん」	It did when I bought it.	「買った時は合ってたもん」
「Sigh...」	「はあ……」	Sigh...	「はあ……」
「If you ever buttoned it, you would have noticed sooner that it doesn't fit you anymore.」	「お前が普段から留めていたなら、もっと早く気づけたものを……」	If you ever buttoned it, you would have noticed sooner that it doesn't fit you anymore.	「お前が普段から留めていたなら、もっと早く気づけたものを……」
「What are you smiling about?」	「なにニヤニヤしてるんだよ」	What are you smiling about?	「おい、何でニヤニヤしてるんだよ」
「It means my boobs got bigger again!」	「胸がまた大きくなったってことだね！」	It means my boobs got bigger again!	「胸がまた大きくなったってことだね！」
「D-Don't say that out loud!!」	「で、デカい声で言うな！」	D-Don't say that out loud!!	「で、デカい声で言うな！」
「Ehehe~」	「えへへ～」	Ehehe~	「えへへ～っ」
「Anyway...」	「ともかく……」	Anyway...	「じゃあ……」
「You look much better now, so...」	「これで少しは見た目がマシになったし……」	You look much better now, so...	「これで少しはマシな見た目になったし……」
「Ah...」	「ん……」	Ah...	「あのね……」
...Why does it feel strange to see Sayori's blazer buttoned up like that?	……なぜサヨリのブレザーのボタンが留まってる姿が不思議に見えるのだろう？	...Why does it feel strange to see Sayori's blazer buttoned up like that?	……なぜブレザーのボタンを留めたサヨリの姿が不思議に見えるのだろう？
「But it's so stuffy...」	「でもきつい……」	But it's so stuffy...	「でも、キツイ……」
「Uuu...」	「うう……」	Uuu...	「うう……」
「It's not worth it at all!」	「こんなの割に合わないよー！」	It's not worth it at all!	「こんなの、いらないよー！」
Sayori hastily unbuttons her blazer once more.	サヨリは大急ぎでまたボタンを外していってしまった。	Sayori hastily unbuttons her blazer once more.	サヨリは大急ぎでまたボタンを外していってしまった。
「Phew!」	「ふぅ！」	Phew!	「ふぅ！」
「That's so much better~」	「やっぱりこっちがいい～」	That's so much better~	「やっぱりこっちがいい～」
Sayori puts her arms out and twirls around.	サヨリは手を伸ばしてくるくる回る。	Sayori puts her arms out and twirls around.	サヨリは手を伸ばしてくるくる回る。
「So if I keep it unbuttoned then I won't get a boyfriend, right?」	「ボタンを外してるうちは彼氏できないんでしょ～？」	So if I keep it unbuttoned then I won't get a boyfriend, right?	「ボタンを外してるうちは彼氏できないんでしょ～？」
「What kind of logic is that?」	「どういう理屈だよ」	What kind of logic is that?	「どういう理屈だよ」
「And why are you saying that like it's a good thing?」	「あとなんでいいことみたいに言うんだよ」	And why are you saying that like it's a good thing?	「あと、何で良いことみたいに言うんだよ」
「Because...」	「だって……」	Because...	「だって……」
「...If I had a boyfriend, then he wouldn't even let you do things like this!」	「……彼氏ができちゃったら、きっとこういうことはさせてくれなくなるもん！」	...If I had a boyfriend, then he wouldn't even let you do things like this!	「……彼氏ができちゃったら、きっとこういうこと、してくれなくなるもん！」
「And you take care of me better than anyone else would, anyway...」	「[player]は誰よりもわたしの面倒をよく見てくれるし……」	And you take care of me better than anyone else would, anyway...	「[player]は、誰よりもわたしの面倒をよく見てくれるし……」
「So that's why I'm keeping it unbuttoned!」	「だから外したままにしとく！」	So that's why I'm keeping it unbuttoned!	「だから、外したままにしとく！」
「Stop saying all these embarrassing things!」	「恥ずかしいことをベラベラ言うな！」	Stop saying all these embarrassing things!	「恥ずかしいことをベラベラ言うな！」
「Eh?」	「えっ？」	Eh?	「ええっ？」
「I didn't say anything embarrassing...」	「何も恥ずかしいことなんて言ってないのに……」	I didn't say anything embarrassing...	「何も恥ずかしいことなんて言ってないのに……」
「Jeez...」	「ったく……」	Jeez...	「はあ……」
「Well anyway, just focus on trying to wake up a little earlier...」	「とにかく、お前はもう少し早く起きることに専念することだな……」	Well anyway, just focus on trying to wake up a little earlier...	「とにかく、お前はもう少し早く起きることに専念してくれ……」
「Only if you focus on going to bed earlier!」	「そっちが早く寝るようになったら！」	Only if you focus on going to bed earlier!	「そっちが早く寝るようになったらね！」
「Fine, fine...」	「分かった、分かった……」	Fine, fine...	「はいはい……」
「It's a deal.」	「取引成立だな」	It's a deal.	「取引成立だな」
「Ehehe~」	「えへへ～」	Ehehe~	「えへへ～っ」
「I guess we really are better at taking care of each other than we are at taking care of ourselves.」	「わたしたちってほんとに自分より、お互いの面倒を見る方が上手みたいだね」	I guess we really are better at taking care of each other than we are at taking care of ourselves.	「わたしたちってホントに、自分よりお互いの面倒を見る方が上手みたいだね」
「Yeah, I guess so, huh...」	「ああ、そうみたいだな……」	Yeah, I guess so, huh...	「ああ、そうみたいだな……」
「So maybe you should come wake me up in the morning!」	「だから朝起こしにきてくれればいいんだよ！」	So maybe you should come wake me up in the morning!	「だから、朝起こしに来てくれればいいんだよ！」
「You're doing it again, Sayori...」	「またそれか、サヨリ……」	You're doing it again, Sayori...	「またそれか、サヨリ……」
「Aw, but I was joking that time!」	「え～、今のは冗談だったのに！」	Aw, but I was joking that time!	「え～、冗談だよ、冗談！」
「Man, it's impossible to tell with you sometimes.」	「お前の言うことはたまに本気かどうか分からなくなる……」	Man, it's impossible to tell with you sometimes.	「お前の言うことは、たまに本気かウソか、わからなくなる……」
「Okay, everyone!」	「よし、みんな！」	Okay, everyone!	「よし、みんな！」
「Eh?」	「ん？」	Eh?	「えっ？」
Monika suddenly calls out.	モニカが突然呼びかけてきた。	Monika suddenly calls out.	モニカが突然呼びかけてきた。
「Why don't we share the poems we wrote now?」	「そろそろ詩を見せ合いましょうか？」	Why don't we share the poems we wrote now?	「そろそろ詩の見せ合いっこをしましょうか？」
「Yay~!」	「やった～！」	Yay~!	「やった～！」
「[player], I can't wait to read yours!」	「[player]の読むの楽しみ！」	[player], I can't wait to read yours!	「[player]の読むの、楽しみ！」
「Yeah, same...」	「俺も……」	Yeah, same...	「俺もー……」
I fail to sound enthusiastic, but Sayori still trots away to retrieve her poem.	どう聞いても声は楽しみそうではなかったが、サヨリは構わず急ぎ足で自分の詩を取りに行った。	I fail to sound enthusiastic, but Sayori still trots away to retrieve her poem.	どう聞いても楽しみにしているような声は出せなかったが、サヨリは構わず急ぎ足で自分の詩を取りに行った。
