「You know, it's around the time that everyone my year starts to think about college...」	「そういえば、私の学年の人たちが大学のことを考え始めるのって、ちょうどこの時期よね」	You know, it's around the time that everyone my year starts to think about college...	「そういえば、私の学年の人たちが大学のことを考え始めるのって、ちょうどこの時期よね」
「It's a really turbulent time for education.」	「学校生活の中でも波乱の時期よね」	It's a really turbulent time for education.	「学校生活の中でも波乱の時期よね」
「We're at the height of this modern expectation that everyone has to go to college, you know?」	「絶対進学しなきゃいけないという現代的な期待の高まりがピークを迎えてるのよ？」	We're at the height of this modern expectation that everyone has to go to college, you know?	「絶対進学しなきゃいけないって現代的な期待の高まりがピークを迎えてるのよ？」
「Finish high school, go to college, get a job - or go to grad school, I guess.」	「高校を卒業して、大学に進学して、就職して……もしくは大学院に行って、かしら」	Finish high school, go to college, get a job - or go to grad school, I guess.	「高校を卒業して、大学に進んで、就職して……もしくは大学院に行って、かしら」
「It's like a universal expectation that people just assume is the only option for them.」	「それしか選択肢はないって思い込む人がたくさんいるみたいなの」	It's like a universal expectation that people just assume is the only option for them.	「それしか選択肢はないって思い込む人がたくさんいるみたいなの」
「They don't teach us in high school that there are other options out there.」	「他にも選択肢はあるって高校で教わらないもの」	They don't teach us in high school that there are other options out there.	「他にも選択肢はあるって高校で教わらないもの」
「Like trade schools and stuff, you know?」	「例えば専修学校とかもあるじゃない？」	Like trade schools and stuff, you know?	「例えば専門学校とかもあるじゃない？」
「Or freelance work.」	「あとフリーランスとか」	Or freelance work.	「あとフリーランスとか」
「Or the many industries that value skill and experience more than formal education.」	「あるいは学歴よりスキルと経験を重視する業界とか」	Or the many industries that value skill and experience more than formal education.	「あるいは学歴よりスキルと経験を重視する業界とか」
「But you have all these students who have no idea what they want to do with their life...」	「でも人生で何をしたいのか分からない学生がたくさんいて……」	But you have all these students who have no idea what they want to do with their life...	「でも人生で何をしたいのかわからない学生がたくさんいて……」
「And instead of taking the time to figure it out, they go to college for business, or communication, or psychology.」	「時間をかけてそれを考えずに、とりあえず経営、コミュニケーション、心理学などの学部に進んでいく」	And instead of taking the time to figure it out, they go to college for business, or communication, or psychology.	「時間をかけてそれを考えずに、とりあえず経営、コミュニケーション、心理学なんかの学部に進んでいく」
「Not because they have an interest in those fields...」	「その理由も、その分野に興味があるからじゃなくて……」	Not because they have an interest in those fields...	「その理由も、その分野に興味があるからじゃなくて……」
「...but because they just hope the degree will get them some kind of job after college.」	「そこで得られる学位で、卒業後の仕事を獲得することを期待してるのよ」	...but because they just hope the degree will get them some kind of job after college.	「そこで得られる学位で、卒業後の仕事を獲得することを期待してるのよ」
「So the end result is that there are fewer jobs to go around for those entry-level degrees, right?」	「そうなると、基本的な学位を所持した人たちの仕事の競争は激しくなるでしょ？」	So the end result is that there are fewer jobs to go around for those entry-level degrees, right?	「そうなると、基本的な学位を持った人たちにとっては仕事の競争率が激しくなるでしょ？」
「So the basic job requirements get higher, which forces even more people to go to college.」	「その結果、職務要件の水準も高まって、更に多くの人々が大学に行かないといけなくなってしまう」	So the basic job requirements get higher, which forces even more people to go to college.	「その結果、職務要件の水準も高まって、さらに多くの人々が大学に行かないといけなくなってしまう」
「And colleges are also businesses, so they just keep raising their prices due to the demand...」	「そして大学もビジネスだから、需要が上がるにつれて授業料も上がっていって……」	And colleges are also businesses, so they just keep raising their prices due to the demand...	「そして大学もビジネスだから、需要が上がるにつれて授業料も上がっていって……」
「...So now we have all these young adults, tens of thousands of dollars in debt, with no job.」	「……最終的に残るのは、何百万もの借金を抱えて、仕事のない若者たち」	...So now we have all these young adults, tens of thousands of dollars in debt, with no job.	「……最終的に残るのは、何百万もの借金を抱えて、仕事のない若者たち」
「But despite all that, the routine stays the same.」	「そんな状態にも関わらず、それはずっと繰り返されていく」	But despite all that, the routine stays the same.	「そんな状態にも関わらず、このお決まりの流れはずっと繰り返されていく」
「Well, I think it's going to start getting better soon.」	「でもそれもこれから良くなっていくと思うわ」	Well, I think it's going to start getting better soon.	「でも、すぐに良くなっていくと思うわ」
「But until then, our generation is definitely suffering from the worst of it.」	「それまでは、私たちの世代はこの最悪の状態で苦しむことになってしまうと思うけど」	But until then, our generation is definitely suffering from the worst of it.	「それまで、私たちの世代はこの最悪の状態で苦しむことになってしまうと思うけど」
「I just wish high school prepared us a little better with the knowledge we need to make the decision that's right for us.」	「人生の最善の選択をするための勉強を、高校の頃にもっと教えてくれたらいいのにね」	I just wish high school prepared us a little better with the knowledge we need to make the decision that's right for us.	「人生で最善の選択をするための勉強を、高校の頃にもっと教えてくれたらいいのにね」
