「Ugh...!」	「もうっ……！」	Ugh...!	「もうっ……！」
I hear Natsuki utter an exasperated sigh from within the closet.	ナツキの苛立った声が部室のクローゼットから聞こえた。	I hear Natsuki utter an exasperated sigh from within the closet.	ナツキの苛立った声が部室の物置から聞こえた。
She seems to be annoyed by something.	何かに怒っているようだ。	She seems to be annoyed by something.	何かに怒っているようだ。
I approach her, in case she needs a hand.	もし手が必要であればと思い、俺は彼女に近づいた。	I approach her, in case she needs a hand.	もし手が必要であればと思い、俺は彼女に近づいた。
「You looking for something in there?」	「その中で探し物か？」	You looking for something in there?	「物置で探し物か？」
「Freaking Monika...」	「モニカのやつ……」	Freaking Monika...	「モニカのやつ……」
「She never puts my stuff back in the right spot!」	「あいつ絶対にわたしの物を元の場所に戻してくれないんだもの！」	She never puts my stuff back in the right spot!	「アイツ、絶対にアタシの物を元の場所に戻してくれないんだもの！」
「What's the point in keeping your collection organized if someone else is just gonna mess it up?」	「ちゃんと整頓してるのに誰かさんのせいですぐゴチャゴチャになるから意味無いじゃない！」	What's the point in keeping your collection organized if someone else is just gonna mess it up?	「ちゃんと整頓してるのに誰かさんのせいですぐゴチャゴチャになるから、意味ないじゃない！」
Natsuki slides a bunch of stacked books and boxes across the shelf.	ナツキは積み上げられた本や箱を棚に収めていく。	Natsuki slides a bunch of stacked books and boxes across the shelf.	ナツキは積み上げられた本や箱を棚に滑らせる。
「Manga...」	「マンガか……」	Manga...	「マンガか……」
「You read manga, right?」	「あんたも読むんでしょ？」	You read manga, right?	「アンタも読むんでしょ？」
「Ah--」	「ああ……」	Ah--	「えっと……」
「...Sometimes...」	「……たまには……」	...Sometimes...	「……たまには……」
Manga is one of those things where you can't admit you're really into it until you figure out where the other person stands.	マンガとは相手をよく知るまで中々打ち明けられないような趣味の一つだ。	Manga is one of those things where you can't admit you're really into it until you figure out where the other person stands.	マンガとは、相手をよく知るまではなかなか打ち明けにくい趣味なのだ。
「...How did you know, anyway?」	「……ていうか、何で知ってるんだ？」	...How did you know, anyway?	「……ていうか、何で知ってるんだ？」
「I heard you bring it up at some point.」	「いつだったかあんたが話してたのを聞いたから」	I heard you bring it up at some point.	「いつだったか、アンタが話してたのを聞いたから」
「Besides, it's kind of written on your face.」	「それに、なんか顔に書いてあるし」	Besides, it's kind of written on your face.	「それに、何か顔に書いてあるし」
What's that supposed to mean...?	どういう意味だそれは……？	What's that supposed to mean...?	どういう意味だ、それは……？
「I-I see...」	「そ、そうか……」	I-I see...	「そ、そうか……」
There's a lone volume of manga amidst a stack of various books on the side of one of the shelves.	様々な本やマンガの山の間に、一つだけぽつんと置いてあるマンガを見つけた。	There's a lone volume of manga amidst a stack of various books on the side of one of the shelves.	様々な本の山の間に、一巻だけぽつんと置いてあるマンガを見つけた。
Curious, I pull it out of the stack.	気になって、俺はそのマンガを引っ張り出してみた。	Curious, I pull it out of the stack.	気になって、俺はそのマンガを引っ張り出す。
「<i>There</i> it is!」	「<i>あった！</i>」	<i>There</i> it is!	「<i>あった！</i>」
Natsuki snatches it out of my hand.	ナツキがそれをひったくる。	Natsuki snatches it out of my hand.	ナツキがそれをひったくる。
She then turns to a box of manga and slips the volume right into the middle of the rest.	ナツキは中にマンガが並んだ箱を開け、それをマンガの列のちょうど真ん中にしまった。	She then turns to a box of manga and slips the volume right into the middle of the rest.	そして中にマンガが並んだ箱を開けると、それをマンガの列のちょうど真ん中にしまった。
「Aah, much better!」	「ふう、これでよし！」	Aah, much better!	「ふう、これでよし！」
「Seeing a box set with one book missing is probably the most irritating sight in the world.」	「綺麗に本が並んでるのに一つだけ欠けてるのを見るとどうしても気になっちゃうのよね」	Seeing a box set with one book missing is probably the most irritating sight in the world.	「全巻セットで一冊だけ欠けてるのを見ると、どうしても気になっちゃうのよね」
「I know that feel...」	「それは分かる……」	I know that feel...	「それはわかる……」
I get a closer look at the box set she's admiring.	俺も近づいてナツキがうっとりと眺める箱の中を見てみる。	I get a closer look at the box set she's admiring.	俺は近づいて、ナツキがうっとりと眺める箱の中をのぞき込んだ。
「Parfait Girls...?」	「『パフェガールズ』……？」	Parfait Girls...?	「『パフェガールズ』……？」
It's a series I've never heard of in my life.	人生で一度も聞いたこともない作品だ。	It's a series I've never heard of in my life.	人生で一度も聞いたこともない作品だ。
That probably means it's either way out of my demographic, or it's simply terrible.	つまりこれは俺の守備範囲外か、単純に面白くないかのいずれかだろう……	That probably means it's either way out of my demographic, or it's simply terrible.	つまりこれは俺の守備範囲外か、単純に面白くないかのいずれかだろう……
「If you're gonna judge, you can go do it through the glass on that door.」	「偏見の目で見るならあの窓ガラスの外から見てなさい」	If you're gonna judge, you can go do it through the glass on that door.	「偏見の目で見るならあの窓ガラスの外から見てなさい」
She points to the classroom door.	ナツキは教室の扉を指差す。	She points to the classroom door.	ナツキは教室のドアを指差す。
「H-Hey, I wasn't judging anything...!」	「へっ、偏見とかじゃない！」	H-Hey, I wasn't judging anything...!	「へっ、偏見とかじゃない！」
「I didn't even say anything.」	「まだ何も言ってないだろ」	I didn't even say anything.	「まだ何も言ってないだろ」
「It was the tone of your voice.」	「あんたの言い方でそう感じたから」	It was the tone of your voice.	「アンタの言い方でそう感じたから」
「But I'll tell you one thing, [player].」	「でも一つだけ教えておくわ、[player]」	But I'll tell you one thing, [player].	「でも、一つだけ教えておくわ、[player]」
「Consider this a lesson straight from the Literature Club: Don't judge a book by its cover!」	「これは文芸部直々の教えだと思いなさい。本を表紙で判断しないことよ！」	Consider this a lesson straight from the Literature Club: Don't judge a book by its cover!	「これは文芸部直々の教えだと思いなさい。本を表紙で判断しないことよ！」
「In fact--」	「むしろ――」	In fact--	「だから――」
Natsuki pulls out the first volume of Parfait Girls from the box.	ナツキは『パフェガールズ』の一巻を箱から引っ張り出した。	Natsuki pulls out the first volume of Parfait Girls from the box.	ナツキが『パフェガールズ』の第１巻を箱から引っ張り出す。
「I'm gonna show you exactly why!」	「それがどういうことか教えてあげる！」	I'm gonna show you exactly why!	「それがどういうことか教えてあげる！」
She shoves the book right into my hands.	そしてそれを俺の手に押し付けた。	She shoves the book right into my hands.	そしてそれを俺の手に押しつけた。
「Ah...」	「おい……」	Ah...	「あのね……」
I stare at the cover.	俺は表紙を眺める。	I stare at the cover.	俺は表紙を眺める。
It features four girls in colorful attire striking animated feminine poses.	そこにはカラフルな衣装を纏った４人の女の子がアニメっぽいポーズをとっているのが描かれている。	It features four girls in colorful attire striking animated feminine poses.	そこにはカラフルな衣装をまとい、アニメっぽいポーズをとった４人の女の子が描かれていた。
It's...exceedingly "moe".	非常に……『萌え』だ。	It's...exceedingly "moe".	非常に……『萌え』だ。
「Don't just stand there!」	「突っ立ってるんじゃないわよ！」	Don't just stand there!	「突っ立ってるんじゃないわよ！」
「Uwa--」	「うわっ――」	Uwa--	「うわっ――」
Natsuki grabs my arm and pulls me out of the closet.	ナツキは俺の腕を掴んでクローゼットの中から引っ張り出した。	Natsuki grabs my arm and pulls me out of the closet.	ナツキは俺の腕をつかんで物置から引っ張り出した。
She then takes a seat against the wall, beneath the windowsills.	そして彼女は窓際の壁を背に床に座り込んだ。	She then takes a seat against the wall, beneath the windowsills.	そして、窓際の壁を背にして床に座り込む。
She pats on the ground next to her, signaling me to sit there.	すぐ隣の床を手でとんとん叩き、俺にそこに座るよう合図する。	She pats on the ground next to her, signaling me to sit there.	彼女は自分の隣の床をぺたぺたと叩き、俺にそこに座るよう合図した。
「Wouldn't chairs be more comfortable...?」	「椅子に座った方がいいんじゃないのか……？」	Wouldn't chairs be more comfortable...?	「椅子に座った方が良くないか……？」
I take my seat.	そう言いつつ俺も隣に座る。	I take my seat.	そう言いつつ、俺も隣に座る。
「Chairs wouldn't work.」	「椅子じゃダメ」	Chairs wouldn't work.	「椅子じゃダメ」
「We can't read at the same time like that.」	「それだと同時に読めないでしょ」	We can't read at the same time like that.	「それだと一緒に読めないでしょ」
「Eh? Why's that?」	「えっ？ なんで？」	Eh? Why's that?	「一緒に？」
「Ah...I guess it's easier to be close together like this...」	「ああ……確かにこうした方が近づけるか……」	Ah...I guess it's easier to be close together like this...	「ああ……確かにこうした方が近づけるか……」
「--!」	「――っ！」	--!	「――っ！」
「D-Don't just say that!」	「い、言うんじゃないわよ！」	D-Don't just say that!	「い、言うんじゃないわよ！」
「You'll make me feel weird about it!」	「気まずくなるでしょ！」	You'll make me feel weird about it!	「気まずくなるでしょ！」
Natsuki crosses her arms and scootches an inch away from me.	ナツキは腕を組むと床を滑って離れてしまった。	Natsuki crosses her arms and scootches an inch away from me.	ナツキは腕を組むと、座ったまま体をずらして俺から少し離れてしまった。
「Sorry...」	「悪い……」	Sorry...	「悪い……」
I didn't exactly expect to be sitting this close to her, either...	俺もまさかこんなに接近することになるとは思わなかったが……	I didn't exactly expect to be sitting this close to her, either...	まさかこんなに接近して座ることになるとは思わなかったが……
Not that I can say it's a particularly bad thing.	まあ、嫌という訳ではないが、な。	Not that I can say it's a particularly bad thing.	まあ、特に嫌というわけでもない。
I open the book.	俺はマンガを開いた。	I open the book.	俺はマンガを開いた。
It's only a few seconds before Natsuki once again inches closer, reclaiming the additional space while she hopes I won't notice.	しばらくするとナツキは俺に気づかれまいとゆっくり近付き、元の場所まで戻ってきた。	It's only a few seconds before Natsuki once again inches closer, reclaiming the additional space while she hopes I won't notice.	ナツキが再びこちらに近づき、俺に気づかれまいとしながら元の場所へ戻ってくるまで、数秒もかからなかった。
I can feel her peering over my shoulder, much more eager to begin reading than I am.	俺の肩の横から覗き込む彼女が、俺よりも読み始めるのを楽しみにしているのが分かる。	I can feel her peering over my shoulder, much more eager to begin reading than I am.	肩越しにのぞき込んでくる彼女が、読み始めるのを俺よりも楽しみにしているのがわかる。
「Wow, how long has it been since I read the beginning...?」	「冒頭を読むのも随分久しぶりね……」	Wow, how long has it been since I read the beginning...?	「最初の方を読むの、久しぶりだわ……」
「Hm?」	「ん？」	Hm?	「え？」
「You don't go back and flip through the older volumes every now and then?」	「時々前の方を読み返したりしないのか？」	You don't go back and flip through the older volumes every now and then?	「時々読み返したりしないのか？」
「Not really.」	「そんなにしないわね」	Not really.	「そんなにしないわね」
「Maybe sometimes after I've already finished the series.」	「全巻読み終わったらたまにするくらいかしら」	Maybe sometimes after I've already finished the series.	「全巻読み終わったら、たまにするくらいかしら」
「Hey, are you paying attention?」	「それより、ちゃんと読んでるの？」	Hey, are you paying attention?	「それより、ちゃんと読んでんの？」
「Uh...」	「あー……」	Uh...	「あー……」
I am, but nothing's really happened yet, so I can talk at the same time.	読んではいるが話に大きな展開は起きていないから、まだ会話をすることはできる。	I am, but nothing's really happened yet, so I can talk at the same time.	読んではいるが、まだ話に大きな展開は起こっていないから、会話をすることはできる。
It looks like it's about a bunch of friends in high school.	仲の良い女子高生たちの話のようだ。	It looks like it's about a bunch of friends in high school.	これは仲の良い女子高生たちの話のようだ。
Typical slice-of-life affair.	よくある日常系ってやつだ。	Typical slice-of-life affair.	よくある日常系ってやつだ。
I kind of grew out of these, since it's rare for the writing to be entertaining enough to make up for the lack of plot.	話の筋がなくても面白い作品は稀だから、最近は読まなくなってしまったジャンルだ。	I kind of grew out of these, since it's rare for the writing to be entertaining enough to make up for the lack of plot.	話の筋がなくても面白い作品は稀だから、最近は読まなくなってしまったジャンルだ。
「So...」	「で……」	So...	「それで……」
「What should I expect from this?」	「これってなんの話なんだ？」	What should I expect from this?	「これって、どんな話なんだ？」
「Is there going to be plot?」	「むしろこの話に筋はあるのか？」	Is there going to be plot?	「むしろこの話に筋はあるのか？」
「Well, obviously!」	「あるに決まってるでしょ！」	Well, obviously!	「あるに決まってるでしょ！」
「You think I would enjoy something that didn't have a plot?」	「話の筋のないものをわたしが読むとでも思ってるの？」	You think I would enjoy something that didn't have a plot?	「話の筋のないものをアタシが読むとでも思ってんの？」
「I mean...」	「だって……」	I mean...	「ここが……」
「Well, I guess I know what you're saying...」	「まあ、言いたいことは分かる気がするわ……」	Well, I guess I know what you're saying...	「まあ、言いたいことはわかる気がするわ……」
「A lot of the beginning is about simple things...」	「確かに最初の方は単純な話が多いわ……」	A lot of the beginning is about simple things...	「確かに最初の方は単純な話が多い……」
「Like there's a really funny chapter where they're obsessed with a guy at the ice cream shop...」	「中にはアイス屋のお兄さんをみんなが大好きになっちゃう、すっごく笑える話とかもあるわよ」	Like there's a really funny chapter where they're obsessed with a guy at the ice cream shop...	「中にはアイス屋のお兄さんをみんなが大好きになっちゃう、すっごく笑える話とかもあるわよ」
「But that just helps you get to know the characters!」	「それを読めばキャラの理解が深まるわ！」	But that just helps you get to know the characters!	「それを読めばキャラの理解が深まるわ！」
「And besides, it's still entertaining.」	「それに、それだけでも面白いんだけど」	And besides, it's still entertaining.	「それに、それだけでも面白いんだけど」
「But later on, there's all kinds of drama...」	「次第にドラマチックな展開が増えるの」	But later on, there's all kinds of drama...	「どんどんドラマチックな展開が増えるの」
「Like when they get into all their backstories, and when some of the romance starts to happen...」	「キャラを深く掘り下げてから恋愛関係の話が始まると……」	Like when they get into all their backstories, and when some of the romance starts to happen...	「キャラを深く掘り下げてから恋愛関係の話が始まると……」
「That's really what makes it so good.」	「どんどん引き込まれていくんだから」	That's really what makes it so good.	「どんどん引き込まれていくんだから」
「There are so many touching parts.」	「感動的なシーンがいっぱいあるのよ」	There are so many touching parts.	「感動的なシーンがいっぱいあるのよ」
「Ah, is that so?」	「へえ、そんな感じなんだな」	Ah, is that so?	「あら、そんな感じなんですね」
「It sounds like you really know what you're talking about.」	「本当にマンガをよく読み込んでるんだな」	It sounds like you really know what you're talking about.	「このマンガ、相当読み込んでるんだな」
「Maybe I underestimated you.」	「少し見直したよ」	Maybe I underestimated you.	「少し見直したよ」
「Ehehe.」	「えへへっ」	Ehehe.	「えへへ」
「...Hey, wait!」	「……って！ ちょっと！」	...Hey, wait!	「……って！ ちょっと！」
「What's <i>that</i> supposed to mean?!」	「それってどういうことよ！？」	What's <i>that</i> supposed to mean?!	「<i>それって</i>どういうことよ！？」
「Uwa--」	「わっ――」	Uwa--	「うわっ――」
Natsuki gives me a little shove.	ナツキに軽く押される。	Natsuki gives me a little shove.	ナツキに小突かれる。
「I just meant that I haven't yet seen you at your full power...」	「いや、本気のお前を今まで見たことがなかったってだけで……」	I just meant that I haven't yet seen you at your full power...	「いや、本気のお前を今まで見たことがなかったってだけで……」
「Hmph. Good save.」	「ふん。そういうことにしといてあげるわ」	Hmph. Good save.	「ふん。そういうことにしといてあげるわ」
「Ah... This chapter seems like it's about baking.」	「へえ……これはお菓子作りの回か」	Ah... This chapter seems like it's about baking.	「へえ……これはお菓子づくりの回か」
「This is just a guess, but is there a lot of baking in this manga?」	「これってもしかしてお菓子作りのシーンが多いのか？」	This is just a guess, but is there a lot of baking in this manga?	「もしかしてこのマンガ、お菓子づくりのシーンが多いとか？」
「Well--」	「それは――」	Well--	「それは――」
Natsuki pauses for a moment, as if she doesn't want to admit something.	ナツキは何かを認めたくないかのように一瞬止まった。	Natsuki pauses for a moment, as if she doesn't want to admit something.	ナツキは認めたくないことがあるかのように一瞬言葉に詰まった。
「...Yeah.」	「……そうよ」	...Yeah.	「……そうだけど」
「Why does that matter?」	「それがどうかしたの？」	Why does that matter?	「それがどうかした？」
「It doesn't, I was just curious...」	「いや、気になっただけだ……」	It doesn't, I was just curious...	「いや、気になっただけだ……」
「Since you enjoy baking too, right?」	「お前もお菓子作りが好きなんだろ？」	Since you enjoy baking too, right?	「お前もお菓子づくりが好きなんだろ？」
「That's--」	「それは――！」	That's--	「それは――」
「Just a coincidence!」	「たまたまよ！」	Just a coincidence!	「たまたまよ！」
「I just happened to get into baking around the same time I got this manga.」	「このマンガを読み始めた同じ時期にお菓子作りにハマりだしたの」	I just happened to get into baking around the same time I got this manga.	「このマンガを読み始めたのと同じ時期に、たまたまお菓子づくりにハマっただけ」
「Like I would ever get into anything because it's in a manga.」	「マンガで見たからって何か始めたりするわけないでしょ！」	Like I would ever get into anything because it's in a manga.	「マンガで見たからって何か始めたりするわけないでしょ！」
「I feel bad for anyone that impressionable.」	「そんなに単純な人がいたら同情するわ！」	I feel bad for anyone that impressionable.	「そんなに単純な人がいたら同情するわ！」
「Ahaha!」	「あ、あははっ！」	Ahaha!	「でしょ！？」
Definitely not a coincidence...	絶対たまたまじゃない……	Definitely not a coincidence...	絶対たまたまじゃない……。
I guess that explains Natsuki's interest in baking.	ナツキがお菓子作りが好きな理由が分かった気がする。	I guess that explains Natsuki's interest in baking.	ナツキがお菓子づくりが好きな理由は、きっとこのマンガだ。
Still, of all the hobbies to pick up from a manga, that's definitely one of the better ones.	それでも、マンガからハマった趣味の中でも、間違いなくそれは良い趣味の一つだろう。	Still, of all the hobbies to pick up from a manga, that's definitely one of the better ones.	それでも、マンガに影響を受けた趣味の中でも、間違いなく良い趣味の一つだろう。
Not to mention she's really good at it, so who am I to judge?	それにかなり上手いんだから文句のつけようがないよな？	Not to mention she's really good at it, so who am I to judge?	それに、実際かなりうまいんだから、文句のつけようもない。
...	……	...	「……」
We read on for a few more minutes.	数分間、二人でマンガを読み進める。	We read on for a few more minutes.	数分間、二人でマンガを読み進める。
I've finished a couple chapters at this point.	俺はこの時点で何話かは読み終えていた。	I've finished a couple chapters at this point.	俺はこの時点で数話を読み終えていた。
「...」	「……」	...	「……」
「...Are you sure this isn't boring for you?」	「……このままじゃお前は退屈しないか？」	...Are you sure this isn't boring for you?	「……このままで、お前は退屈しないのか？」
「It's not!」	「しないわ！」	It's not!	「しないわ！」
「Even though you're just watching me read?」	「俺がこれを読んでるのを見てるだけなのに？」	Even though you're just watching me read?	「俺が読んでるのを見てるだけなのに？」
「Well...!」	「それは……！」	Well...!	「それは……！」
「I'm...fine with that.」	「それで……いいわ」	I'm...fine with that.	「それで……いいのよ」
「If you say so...」	「そう言うのなら……」	If you say so...	「そっか……」
「...I guess it's fun sharing something you like with someone else.」	「……好きなことを誰かと共有するのって、結構楽しいのかもな」	...I guess it's fun sharing something you like with someone else.	「……好きなことを誰かと共有するのって、結構楽しいのかもな」
「I always get excited when I convince any of my friends to pick up a series I enjoy.」	「俺も好きな作品を友達に勧めて、それを読み始めてくれたら嬉しくなるし」	I always get excited when I convince any of my friends to pick up a series I enjoy.	「俺も好きな作品を友達に勧めて、それを読み始めてくれたら、うれしくなるし」
「You know what I mean?」	「そういうのあるだろ？」	You know what I mean?	「この言葉の意味、わかる？」
「...?」	「……？」	...?	「……？」
「Hm?」	「ん？」	Hm?	「ん？」
「You don't?」	「ないか？」	You don't?	「ないか？」
「Um...」	「えっと……」	Um...	「その……」
「That's not...」	「わたしは……」	That's not...	「アタシは……」
「Well, I wouldn't really know.」	「よく分からないというか」	Well, I wouldn't really know.	「よくわからないというか」
「...What do you mean?」	「……なんだ？」	...What do you mean?	「……なんだ？」
「Don't you share your manga with your friends?」	「友達とマンガの話をしたりしないのか？」	Don't you share your manga with your friends?	「友達とマンガの話をしたりしないのか？」
「Could you not rub it in?」	「あんまりしつこく聞かないでおいてくれる？」	Could you not rub it in?	「あんまりしつこく聞かないでくれる？」
「Jeez...」	「まったく……」	Jeez...	「はあ……」
「Ah... Sorry...」	「あっ、すまん……」	Ah... Sorry...	「あっ、すまん……」
「Hmph.」	「ふん」	Hmph.	「ふん」
「Like I could ever get my friends to read this...」	「こんなの友達に読ませられるわけないでしょ……」	Like I could ever get my friends to read this...	「こんなの友達に読ませられるわけないでしょ……」
「They just think manga is for kids.」	「みんなマンガは子供の娯楽だと思ってるし」	They just think manga is for kids.	「みんなマンガは子どもの娯楽だと思ってるし」
「I can't even bring it up without them being all like...」	「こんな話をしたら絶対……」	I can't even bring it up without them being all like...	「こんな話したら、絶対……」
「Eh? You still haven't grown out of that yet?'」	「『え～？ まだそんなの読んでるの～？』って言われるんだから」	'Eh? You still haven't grown out of that yet?'	「『え～？ まだそんなの読んでるの～？』って言われるんだから」
「Makes me want to punch them in the face...」	「顔を殴ってやりたくなるわ……」	Makes me want to punch them in the face...	「顔を殴ってやりたくなるわ……」
「Urgh, I know those kinds of people...」	「あー、分かる、そういうやついるよな……」	Urgh, I know those kinds of people...	「あー、わかる、そういうやついるよな……」
「Honestly, it takes a lot of effort to find friends who don't judge, much less friends who are also into it...」	「この趣味を理解してくれる人ってそうそういないよな。ただでさえ同志も少ないのに……」	Honestly, it takes a lot of effort to find friends who don't judge, much less friends who are also into it...	「この趣味を理解してくれる人ってそうそういないよな。ただでさえ同志も少ないのに……」
「I'm already kind of a loser, so I guess I gravitated toward the other losers over time.」	「俺は元からはみ出し者だったから、似たような人間が次第に周りに集まってきたけど」	I'm already kind of a loser, so I guess I gravitated toward the other losers over time.	「俺は元からはみ出し者だったから、似たような人間が次第に周りに集まってきたけど」
「But it's probably harder for someone like you...」	「お前みたいなのは大変だと思うよ……」	But it's probably harder for someone like you...	「お前みたいなのは大変だと思うよ……」
「Hm.」	「ふん」	Hm.	「ふん」
「Yeah, that's pretty accurate.」	「まあ、それでだいたい合ってるわ」	Yeah, that's pretty accurate.	「まあ、その通りでしょうね」
<i>...Wait, which part??</i>	<i>……ん？ どの部分がだ？</i>	<i>...Wait, which part??</i>	<i>……待て、どの部分がだ？？</i>
「I mean, I feel like I can't even keep it in my own room...」	「自分の部屋に置くことすらためらうもの……」	I mean, I feel like I can't even keep it in my own room...	「自分の部屋に置くことすらためらうもの……」
「I don't even know what my dad would do if he found this.」	「パパに見つかったらどうなるか分からないし」	I don't even know what my dad would do if he found this.	「パパに見つかったら、どうなるかわからないし」
「At least it's safe here in the clubroom.」	「部室に置いておけば安全だから」	At least it's safe here in the clubroom.	「部室に置いておけば安全だから」
「Cept Monika was kind of a jerk about it...」	「モニカのことはさておき……」	'Cept Monika was kind of a jerk about it...	「どうも嫌がってるモニカはさておき、だけど……」
「Ugh! I just can't win, can I?」	「もう！ どうしてもあいつには勝てないみたいね……」	Ugh! I just can't win, can I?	「もう！ どうしてもアイツには勝てないみたいね……」
「Well, it paid off in the end, didn't it?」	「まあ、置いてた甲斐はあったんじゃないか？」	Well, it paid off in the end, didn't it?	「まあ、置いてた甲斐はあったんじゃないか？」
「I mean, here I am, reading it.」	「俺にもこうやって読ませてくれてるんだし」	I mean, here I am, reading it.	「こうやって俺も読めたしさ」
「Well, it's not like that solves any of my problems.」	「でもなんの解決にもなってないじゃない」	Well, it's not like that solves any of my problems.	「でも、何の解決にもなってないじゃない」
「Maybe...」	「そうかもしれないが……」	Maybe...	「そうかもしれないけど……」
「But at least you're enjoying yourself, right?」	「でも楽しんでるんだろ？」	But at least you're enjoying yourself, right?	「楽しんでるんだろ？」
「--」	「――っ」	--	「――っ」
「...」	「……」	...	「……」
「...So?」	「……それが？」	...So?	「……ふ、ふん」
「Ahaha.」	「ははっ」	Ahaha.	「あははっ」
「Jeez, that's enough!」	「も、もういいでしょ！」	Jeez, that's enough!	「も、もういいでしょ！」
「Are you gonna keep reading, or what?」	「続き読むの？ 読まないの？！」	Are you gonna keep reading, or what?	「続き読むの？ 読まないの？！」
「Yeah, yeah...」	「はいはい……」	Yeah, yeah...	「はいはい……」
I flip the page.	俺はページをめくった。	I flip the page.	俺はページをめくった。
Suddenly, Natsuki starts laughing.	その瞬間、ナツキが突然笑いだした。	Suddenly, Natsuki starts laughing.	その瞬間、ナツキが突然笑いだした。
「Ahahaha!」	「あははははっ！」	Ahahaha!	「あはははっ！」
「I totally forgot that happens!」	「こういう展開だったの、すっかり忘れてたわ！」	I totally forgot that happens!	「こういう展開だったの、すっかり忘れてたわ！」
Natsuki puts her finger on one of the panels.	ナツキは一つのコマを指差した。	Natsuki puts her finger on one of the panels.	ナツキはコマの一つを指差した。
「Minori is my favorite character.」	「ミノリがわたしが一番好きなキャラなんだけど……」	Minori is my favorite character.	「ミノリがわたしの一番好きなキャラなんだけど……」
「You always feel a little bad for her, since she's so unlucky.」	「いつも運が悪いから同情しちゃうのよね」	You always feel a little bad for her, since she's so unlucky.	「いつも運が悪いから同情しちゃうのよね」
「But it gets especially bad when--」	「でも特にひどいのが――」	But it gets especially bad when--	「でも特にひどいのが――」
「Uu...」	「うう……」	Uu...	「うう……」
「I shouldn't be talking about that yet!」	「まだそこは喋ったらダメね」	I shouldn't be talking about that yet!	「まだそこはしゃべったらダメね」
「Just finish this chapter!」	「早くその話を読み終えて！」	Just finish this chapter!	「早くこの話を読み終えて！」
Natsuki's voice sparkles with excitement.	ナツキの声が期待にきらめいて聞こえる。	Natsuki's voice sparkles with excitement.	ナツキの声が期待にきらめいて聞こえる。
It's a stark contrast to her usual bossy tone.	普段の威張った雰囲気とは正反対だ。	It's a stark contrast to her usual bossy tone.	普段の威張った雰囲気とは正反対だ。
But if she's not used to sharing her favorite manga with her friends, I can understand why.	きっと友達と好きなマンガを語ることがないからだろう。	But if she's not used to sharing her favorite manga with her friends, I can understand why.	きっと好きなマンガについて友達と語ることが普段ないからだろう。
It's hard to express in words the feeling you get when connecting with someone like that.	こうやって人と繋がると、言葉では語れないような気持ちになるものだ。	It's hard to express in words the feeling you get when connecting with someone like that.	こうやって人とつながると、言葉にできないような気持ちになるものだ。
And being able to provide that to Natsuki, for whom it's a rare experience...	ナツキにとっては滅多にない機会を俺が作れていると思う……	And being able to provide that to Natsuki, for whom it's a rare experience...	ナツキにとって滅多にない機会を俺がつくれていると思うと……
The thought makes me smile a little to myself.	そんなことを考えていると、俺もつられて少し微笑んでしまう。	The thought makes me smile a little to myself.	俺もつられて少し微笑んでしまう。
「Okay, everyone!」	「よし、みんな！」	Okay, everyone!	「よし、みんな！」
「Eh?」	「ん？」	Eh?	「えっ？」
「Are you all ready with today's poems?」	「今日の詩の準備はできてるかしら？」	Are you all ready with today's poems?	「今日の詩の準備はできてるかしら？」
「...」	「……」	...	「……」
「Oh, come on!」	「ああ、もうっ！」	Oh, come on!	「ちょっと！」
「Could your timing be any worse?」	「今すごく良いところなのに！」	Could your timing be any worse?	「今すごく良いところなのに！」
「Sorry~!」	「ごめんなさい～！」	Sorry~!	「ごめんなさ～い！」
「I just need to make sure we have enough time.」	「時間は充分にとっておきたいの」	I just need to make sure we have enough time.	「時間はたっぷりとっておきたいの」
「Though you do look pretty cozy over there. Ahaha!」	「でも、二人ともそこが居心地よさそうね。ふふふっ！」	Though you do look pretty cozy over there. Ahaha!	「でも、二人ともそこが居心地良さそうね。ふふふっ！」
「Eh...?」	「えっ……？」	Eh...?	「え……？」
「A-Ah!」	「な、なっ……！」	A-Ah!	「あ、あっ……！」
Natsuki suddenly notices how close she's gotten to me.	その瞬間にナツキはどれほど接近していたかに気付き……	Natsuki suddenly notices how close she's gotten to me.	その瞬間にナツキは俺との距離の近さに気付き……
She hastily slides herself a good twelve inches away from me.	瞬時に床を滑っていって俺から30センチほど距離をとってしまった。	She hastily slides herself a good twelve inches away from me.	瞬時に床を滑って、俺から優に30センチは離れてしまった。
「Alright...」	「分かった……」	Alright...	「わかった……」
「Guess I'll stop here for now.」	「今日はここまでにしておくか」	Guess I'll stop here for now.	「今日はここまでにしておくか」
I close the book and hand it towards Natsuki.	俺はマンガを閉じてナツキへ差し出す。	I close the book and hand it towards Natsuki.	マンガを閉じてナツキへ差し出す。
「You're just giving it back...?」	「返すの……？」	You're just giving it back...?	「返すの……？」
「Don't you want to know what happens?」	「続きが気にならないの？」	Don't you want to know what happens?	「続きが気にならないの？」
「Ah... Yeah, but...」	「ま、まあそうだけど……」	Ah... Yeah, but...	「ま、まあ気になるけど……」
「Monika just said--」	「さっきモニカが――」	Monika just said--	「さっきモニカが――」
「Don't be dumb.」	「バカね」	Don't be dumb.	「バカね」
「Just take it home with you.」	「持って帰ればいいじゃない」	Just take it home with you.	「持って帰ればいいじゃない」
「Eh?」	「えっ？」	Eh?	「はっ？」
「...Is that really alright?」	「い、いいのか？」	...Is that really alright?	「い、いいのか？」
I say that mostly because I really didn't plan on using my spare time to read this...	空いた時間で読むつもりはあまりない、と思いつつの発言だったが……	I say that mostly because I really didn't plan on using my spare time to read this...	そう聞いたのは、空いた時間で読むつもりはあまりないからだ……
「Well, of course.」	「当たり前でしょ」	Well, of course.	「当たり前でしょ」
「It would take forever to finish if you didn't take it home.」	「そうでもしないと一生読み終わらないし」	It would take forever to finish if you didn't take it home.	「そうでもしないと一生読み終わらないし」
「Just finish that one before tomorrow, so we can start the next one.」	「明日までに読み終えて、次の巻に進みましょう」	Just finish that one before tomorrow, so we can start the next one.	「明日までに読み終えて、次の巻に進みましょう」
「And if it gets bent, I'll kill you.」	「あと、折ったら殺すわよ」	And if it gets bent, I'll kill you.	「あと、折ったら殺すわよ」
「By tomorrow...?」	「明日までに……？」	By tomorrow...?	「明日までに……？」
I only got partway through the volume so far.	まだ半分も読み終えてないのに。	I only got partway through the volume so far.	まだ半分も読み終えてないのに。
I might fall behind on some shows if I try to get through this...	これを読んでたらアニメを見逃してしまうかもしれない……	I might fall behind on some shows if I try to get through this...	これを読んでたらアニメを見逃してしまうかもしれない……
But I suppose that's a necessary sacrifice in exchange for seeing Natsuki's enthusiastic face.	しかしナツキの喜ぶ顔を見るためには、必要な犠牲なのかもしれない。	But I suppose that's a necessary sacrifice in exchange for seeing Natsuki's enthusiastic face.	しかしナツキの喜ぶ顔を見るためには、多少の犠牲は必要なのかもしれない。
Or am I more scared of what will happen if I <i>don't</i> finish it...?	それとも俺は<i>もし</i>読み終えられなかった時のことを恐れているのだろうか……？	Or am I more scared of what will happen if I <i>don't</i> finish it...?	いや、もっと恐ろしいのは、<i>読み終えられなかった</i>時のことではないか……？
「Alright, then!」	「……分かったよ！」	Alright, then!	「……わかったよ！」
I stand up.	俺は立ち上がる。	I stand up.	俺は立ち上がる。
I return to where I put my stuff and carefully slip the book into my bag.	自分の荷物を置いた場所まで戻り、借りたマンガを慎重にカバンにしまった。	I return to where I put my stuff and carefully slip the book into my bag.	自分の荷物を置いた場所まで戻り、借りたマンガを慎重にカバンにしまった。
