「You know, high school is a really turbulent time in a lot of people's lives.」	「多くの人にとって、高校生活って本当に波瀾万丈なものよね」	You know, high school is a really turbulent time in a lot of people's lives.	「多くの人にとって、高校生活って本当に波瀾万丈なものよね」
「People can get really passionate and dramatic.」	「怒りっぽくなったり、大げさになったりする人もいれば……」	People can get really passionate and dramatic.	「怒りっぽくなったり、大げさになったりする人もいれば……」
「And others have aching hearts and seek attention on social media...」	「中には心を痛めた末にSNSで承認欲求を満たそうとする人もいる……」	And others have aching hearts and seek attention on social media...	「心を痛めた末にSNSで承認欲求を満たそうとする人もいる……」
「But all of the social pressure and hormones can lead to a dark time in people's lives.」	「それに、思春期の悩みや社会的な圧力は人生に暗い影を落とす原因になり得るわ」	But all of the social pressure and hormones can lead to a dark time in people's lives.	「それに、思春期の悩みや社会的な圧力は人生に暗い影を落とす原因になり得るわ」
「Everyone has a story.」	「みんなそれぞれの物語がある」	Everyone has a story.	「みんなそれぞれの物語がある」
「You may not know what someone is really feeling on the inside.」	「他人の本当の気持ちなんて分かってないかも知れない」	You may not know what someone is really feeling on the inside.	「他人の本当の気持ちなんてわかってないのかもしれない」
「Many people who are depressed won't even bother telling the world about it.」	「うつ状態の人はそれを周りに知らせることすら億劫だという場合も多いわ」	Many people who are depressed won't even bother telling the world about it.	「鬱状態の人は、それを周りに知らせることすら億劫だという場合も多いわ」
「They don't want attention, because they've already given up on the inside.」	「心の中ではもう諦めてしまっているから、注目されたくないのよ」	They don't want attention, because they've already given up on the inside.	「そんな人たちは心の中ではもう諦めてしまっているから、注目されたくないのよ」
「Their feeling of worthlessness is so overwhelming that they don't even want people to tell them otherwise.」	「自分は無価値だって感情に打ちのめされすぎて、他人にそれを否定されたくもないのよ」	Their feeling of worthlessness is so overwhelming that they don't even want people to tell them otherwise.	「自分は無価値だって感情に打ちのめされすぎて、誰とも話をしたないの」
「Depression comes in many forms, but that is one of them.」	「うつって色んな形があるけど、それもその中の一つ」	Depression comes in many forms, but that is one of them.	「鬱っていろんな形があるけど、それもその中の一つ」
「Just, if you think you know someone struggling with depression...」	「ただ、もし周りで誰かがうつで苦しんでいると思ったら……」	Just, if you think you know someone struggling with depression...	「ただ、もしまわりで誰かが鬱で苦しんでいると思ったら……」
「You can help just by treating them like they're a good friend.」	「良い友達として接してあげるだけで助けになれるかも知れないわ」	You can help just by treating them like they're a good friend.	「良い友達として接してあげるだけで助けになれるかもしれないわ」
「Spend time with them, even if they don't feel like doing much.」	「何もやる気がなさそうでも、一緒にいてあげて」	Spend time with them, even if they don't feel like doing much.	「何もやる気がなさそうでも、一緒にいてあげて」
「And remind them that they always have something to look forward to.」	「そして常に楽しみがあることを気づかせてあげて」	And remind them that they always have something to look forward to.	「そして常に楽しみがあることを気づかせてあげて」
「Making plans in advance, letting them borrow something, or even just saying 'See you at school tomorrow'...」	「予定を立てたり、何かを貸してあげたり、『また明日学校で』って言うだけでも……」	Making plans in advance, letting them borrow something, or even just saying 'See you at school tomorrow'...	「予定を立てたり、何かを貸してあげたり、『また明日学校で』って言うだけでも……」
「All of those things can help your friend make it to the next day.」	「それは全部、友達が明日に到達する助けになるから」	All of those things can help your friend make it to the next day.	「それは全部、友達が明日に到達する助けになるから」
「I hope being friends with Sayori has given you some perspective on the true face of depression.」	「サヨリと友達になったことで、うつの本当の姿について少しでも学べたなら良いんだけど」	I hope being friends with Sayori has given you some perspective on the true face of depression.	「サヨリと友達になったことで、鬱の本当の姿について少しでも学べたなら良いんだけど」
「Yeah, she's gone now...」	「うん、もういないんだけどね……」	Yeah, she's gone now...	「うん、もういないんだけどね……」
「But Sayori was never real in the first place.」	「でもサヨリは元から本物じゃなかったし」	But Sayori was never real in the first place.	「でもサヨリは元から本物じゃなかったし」
「You're real.」	「あなたは本物」	You're real.	「あなたは本物」
「Your friends are real.」	「あなたの友達も本物」	Your friends are real.	「あなたの友達も本物」
「And just by being a good person, you can save someone's life.」	「そしてあなたは優しい人であることで、誰かの命を救うことだってできる」	And just by being a good person, you can save someone's life.	「そしてあなたは優しい人であることで、誰かの命を救うことだってできる」
「As for you...」	「あなたは……」	As for you...	「あなたは……」
「...You don't struggle with depression or anything like that, do you?」	「……あなたはうつに苦しんでいたりしない？」	...You don't struggle with depression or anything like that, do you?	「……あなたは鬱に苦しんでいたりしない？」
「Because you, too, have people who would want to save your life.」	「あなたがそうであるように、あなたを救いたいと思う人たちがきっとそばにいるから」	Because you, too, have people who would want to save your life.	「あなたがそうであるように、あなたを救いたいと思う人たちはきっとそばにいる」
「Maybe they don't express it every day, or maybe they don't even know how to.」	「普段は表に出さないかもしれないし、そもそもどう伝えればいいのか分からないのかもしれない」	Maybe they don't express it every day, or maybe they don't even know how to.	「普段は表に出さないかもしれないし、そもそもどう伝えればいいのかわからないのかもしれない」
「But people do feel that way.」	「でもそう思ってる人はいるから」	But people do feel that way.	「でもそう思ってる人はいるから」
「I promise.」	「絶対に」	I promise.	「急ぎませんから」
「...Man, humans are complicated!」	「……本当、人間って複雑な生き物ね！」	...Man, humans are complicated!	「……本当、人間って複雑な生き物ね！」
「But as long as you're here with me, I'll take care of you, my love.」	「でもここにいる限り、私が面倒を見てあげるから。私の愛しい人」	But as long as you're here with me, I'll take care of you, my love.	「でもここにいる限り、私が面倒を見てあげるから。私の愛しい人」
