It's an ordinary school day, like any other.	いつもと変わらない学校の日。	It's an ordinary school day, like any other.	いつもと変わらない学校の日。
Mornings are usually the worst, being surrounded by couples and friend groups walking to school together.	朝はいつもカップルや友達グループに囲まれながら学校へ行くのだからたまったものじゃない。	Mornings are usually the worst, being surrounded by couples and friend groups walking to school together.	朝はいつもカップルや友達グループに囲まれながら学校へ行くのだから、たまったものじゃない。
Meanwhile, I've always walked to school alone.	その傍ら、俺はいつも一人で登校していた。	Meanwhile, I've always walked to school alone.	その傍ら、俺はいつも一人で登校していた。
I always tell myself it's about time I meet some girls or something like that...	俺もそろそろ女の子と仲良くなったりするべきなのかもしれないが……	I always tell myself it's about time I meet some girls or something like that...	俺もそろそろ女の子と仲良くなったりするべきなのかもしれないが……
But I have no motivation to join any clubs.	でもどの部活に入る気も無い。	But I have no motivation to join any clubs.	でも、どの部活にも入る気はない。
I'm perfectly content just getting by on the average while spending my free time on games and anime.	暇な時間は大抵アニメかゲームに費やして、平穏な生活が送れればそれで満足だ。	I'm perfectly content just getting by on the average while spending my free time on games and anime.	暇な時間は大抵アニメかゲームに費やして、平穏な生活が送れればそれで満足だ。
There's always the anime club, but it's not like there would be any girls in it anyway...	アニメ研究会があるのは知ってるが、女子は一人もいないだろうしな……	There's always the anime club, but it's not like there would be any girls in it anyway...	アニメ研究会があるのは知ってるが、女子は一人もいないだろうしな……
The school day is as ordinary as ever, and it's over before I know it.	普段通りの学校生活は、いつの間にか終わっていた。	The school day is as ordinary as ever, and it's over before I know it.	普段通りの授業が、気づかぬうちに終わっていく。
After I pack up my things, I stare blankly at the wall, looking for an ounce of motivation.	荷物をまとめた後、自分の中のやる気を探して壁をぼんやりと眺める。	After I pack up my things, I stare blankly at the wall, looking for an ounce of motivation.	帰り支度を終え、壁をぼんやりと眺めながら、自分のやる気を探ってみる。
「Clubs...」	「部活か……」	Clubs...	「部活か……」
There really aren't any that interest me.	別に興味ある部活はなかった。	There really aren't any that interest me.	別に興味のある部活はなかった。
Besides, most of them would probably be way too demanding for me to want to deal with.	それにほとんどの部活が俺が思う以上にキツそうだ。	Besides, most of them would probably be way too demanding for me to want to deal with.	それに、ほとんどの部活が俺が思う以上にキツそうだ。
I guess I have no choice but to start with the anime club...	とりあえずアニメ研究会から始めてみるしかないかな……	I guess I have no choice but to start with the anime club...	とりあえず、アニメ研究会から始めてみるしかないかな……。
「...[player]?」	「……[player]君？」	...[player]?	「……[player]君？」
「...Monika?」	「……モニカ？」	...Monika?	「……モニカ？」
「Oh my goodness, I totally didn't expect to see you here!」	「やっぱりね、ここで会えるとは思わなかったわ！」	Oh my goodness, I totally didn't expect to see you here!	「やっぱりね、ここで会えるとは思わなかったわ！」
「It's been a while, right?」	「久しぶり、よね？」	It's been a while, right?	「久しぶり、よね？」
「Ah...」	「ああ……」	Ah...	「あのね……」
「Yeah, it has.」	「うん、そうだな」	Yeah, it has.	「うん、そうだな」
Monika smiles sweetly.	モニカは優しくほほ笑む。	Monika smiles sweetly.	モニカは優しく微笑む。
We do know each other - well, we rarely talked, but we were in the same class last year.	俺たちは去年同じクラスだったから、お互いのことは知っている。とはいえ滅多に話さないが。	We do know each other - well, we rarely talked, but we were in the same class last year.	去年同じクラスだったから、お互いのことは知っている。とはいえ滅多に話さなかったが。
Monika was probably the most popular girl in class - smart, beautiful, athletic.	モニカは容姿端麗・文武両道。おそらくクラスで一番人気だった女の子だ。	Monika was probably the most popular girl in class - smart, beautiful, athletic.	モニカは容姿端麗・文武両道。おそらくクラスで一番人気だった女の子だ。
Basically, completely out of my league.	要するに、高嶺の花だ。	Basically, completely out of my league.	要するに、高嶺の花だ。
So, having her smile at me so genuinely feels a little...	だから彼女に微笑まれて、なんというか……	So, having her smile at me so genuinely feels a little...	だから彼女に微笑まれると、何と言うか……
「What did you come in here for, anyway?」	「それで、何をしに来たんだ？」	What did you come in here for, anyway?	「それで、何をしに来たんだ？」
「Oh, I've just been looking for some supplies to use for my club.」	「あの、ちょっと部活のための道具を探しにね」	Oh, I've just been looking for some supplies to use for my club.	「あの、ちょっと部活のための道具を探しにね」
「Do you know if there's any construction paper in here?」	「この辺りで、画用紙がある場所を知らない？」	Do you know if there's any construction paper in here?	「この辺りで、画用紙ってどこにあるかしら？」
「Or markers?」	「あと、マーカーとか？」	Or markers?	「あと、マーカーとか？」
「I guess you could check the closet.」	「クローゼットにでも探せばあるんじゃないかな」	I guess you could check the closet.	「物置でも探せばあるんじゃないかな」
「...You're in the debate club, right?」	「お前はディベート部に入ってるんだっけ？」	...You're in the debate club, right?	「……お前はディベート部に入ってるんだっけ？」
「Ahaha, about that...」	「あはは……そうだったけど……」	Ahaha, about that...	「あはは……そうだったけど……」
「I actually quit the debate club.」	「実はディベート部は辞めたの」	I actually quit the debate club.	「実はディベート部は辞めたの」
「Really? You quit?」	「本当に？ 辞めたのか？」	Really? You quit?	「本当に？ 辞めたのか？」
「Yeah...」	「うん……」	Yeah...	よし……
「To be honest, I can't stand all of the politics around the major clubs.」	「正直に言うと、大きな部の部内政治にもううんざりだったの」	To be honest, I can't stand all of the politics around the major clubs.	「正直に言うと、大きな部の部内政治にもううんざりしてね」
「It feels like nothing but arguing about the budget and publicity and how to prepare for events...」	「予算か宣伝かイベントのことしか話していない気がしてね」	It feels like nothing but arguing about the budget and publicity and how to prepare for events...	「予算か宣伝かイベントのことしか話さないの」
「I'd much rather take something I personally enjoy and make something special out of it.」	「そんなことをしてるより、自分が好きなものを通して特別な何かを作りたかったの」	I'd much rather take something I personally enjoy and make something special out of it.	「そんなことより、自分が好きなものを通して特別な何かをつくりたくて」
「In that case, what club did you decide to join?」	「じゃあ、どの部活に入ることにしたんだ？」	In that case, what club did you decide to join?	「じゃあ、どの部活に入ることにしたんだ？」
「Actually, I'm starting a new one!」	「実は新しい部活を始めたの！」	Actually, I'm starting a new one!	「実は新しい部活を始めたの！」
「A literature club!{nw}」	「文芸部よ！{nw}」	A literature club!	「文芸部よ！」
「A literature club!{fast}」	「文芸部よ！{fast}」	A literature club!	「文芸部よ！」
「Literature...?」	「文芸……？」	Literature...?	「文芸……？」
That sounds kind of...dull?	なんというか……退屈そう？	That sounds kind of...dull?	何か……退屈そう……
「How many members do you have so far?」	「部員は何人くらいいるんだ？」	How many members do you have so far?	「部員は何人くらいいるんだ？」
「Um...」	「うーん……」	Um...	「その……」
「Ahaha...」	「あはは……」	Ahaha...	「そうだな……」
「It's kind of embarrassing, but there are only three of us so far.」	「言うのもちょっと恥ずかしいんだけどまだ３人だけなの」	It's kind of embarrassing, but there are only three of us so far.	「言うのもちょっと恥ずかしいんだけど、まだ３人だけなの」
「It's really hard to find new members for something that sounds so boring...」	「あまり面白くなさそうな響きだし、新しい部員を見つけるのもなかなか難しいのよ……」	It's really hard to find new members for something that sounds so boring...	「つまらなさそうって思う人が多くて、新しい部員を見つけるのもなかなか大変なのよ……」
「Well, I can see that...」	「まあ、そうだろうな……」	Well, I can see that...	「まあ、そうだろうな……」
「But it's really not boring at all, you know!」	「でも、実際はとても面白いのよ」	But it's really not boring at all, you know!	「でも、実際はとっても面白いのよ！」
「Literature can be anything. Reading, writing, poetry...」	「文学にもいろいろあって読書、執筆、詩などなど……」	Literature can be anything. Reading, writing, poetry...	「文学にもいろいろあって読書、執筆、詩などなど……」
「I mean, one of my members even keeps her manga collection in the clubroom...」	「部員の中には部室にマンガコレクションを持ち込んでいる人もいるのよ……」	I mean, one of my members even keeps her manga collection in the clubroom...	「部員の中には部室にマンガコレクションを持ち込んでいる子もいるのよ……」
「Wait...really?」	「待てよ……本当か？」	Wait...really?	「待てよ……本当か？」
「Yeah, it's funny, right?」	「うん、おかしいでしょ？」	Yeah, it's funny, right?	「うん、おかしいでしょ？」
「She always insists that manga is literature, too.」	「あの子はいつもマンガは文学だって言い張るの」	She always insists that manga is literature, too.	「あの子はいつもマンガは文学だって言い張るの」
「I mean, she's not wrong, I guess...」	「私も彼女が間違っているとは思わないけど……」	I mean, she's not wrong, I guess...	「私も彼女が間違っているとは思わないけどね……」
「And besides, a member's a member, right?」	「それに、部員は部員でしょう？」	And besides, a member's a member, right?	「それに、部員は部員でしょう？」
...Did Monika say 「she」?	今『彼女』って言った？	...Did Monika say "she"?	今『彼女』って言った？
Hmm...	ほう……	Hmm...	「ふーん……」
「Hey, [player]...」	「ねえ、 [player]君」	Hey, [player]...	「ねえ、[player]君」
「By any chance...are you still looking for a club to join?」	「もしかして、あなた入部する部活を探していたりしない？」	By any chance...are you still looking for a club to join?	「もしかして……あなた、部活を探していたりしない？」
「Ah--」	「ああ……」	Ah--	「えっと……」
「I mean, I guess so, but...」	「まあ、そうだけど……」	I mean, I guess so, but...	「まあ、そうだけど……」
「In that case...」	「それなら……」	In that case...	「そういうことなら……」
「Is there any chance you could do me a big favor?」	「ちょっとお願いしちゃってもいいかしら？」	Is there any chance you could do me a big favor?	「ちょっとお願いしちゃってもいいかしら？」
「I won't ask you to join, but...」	「入部しろとまでは言わないけど……」	I won't ask you to join, but...	「入部しろとまでは言わないけど……」
「If you could at the very least visit my club, it would make me really happy.」	「もしうちの部活を見学してくれたら、うれしいんだけど」	If you could at the very least visit my club, it would make me really happy.	「もしうちの部活を見学してくれたら、うれしいんだけど」
「Please?」	「どうかな？」	Please?	「どうかな？」
「Um...」	「ううん……」	Um...	「ええと……」
Well, I guess I have no reason to refuse...	まあ、特に断る理由もないか。	Well, I guess I have no reason to refuse...	まあ、特に断る理由もないか。
Besides, how could I ever refuse someone like Monika?	そもそも、モニカのような人の頼みごとなんて俺が断れるはずもない。	Besides, how could I ever refuse someone like Monika?	そもそも、モニカのような人の頼みごとを俺が断れるはずもない。
「Sure, I guess I could check it out.」	「いいよ、見学してみてもいいかな」	Sure, I guess I could check it out.	「ああ、見学してみてもいいかな」
「Aah, awesome!」	「わあ、やったあ！」	Aah, awesome!	「わあ、やったあ！」
「You're really sweet, [player], you know that?」	「[player]君、あなたってとてもいい人ね」	You're really sweet, [player], you know that?	「[player]君、あなたってとてもいい人ね」
「I-It's nothing, really...」	「こ、こんなの大したことないから……」	I-It's nothing, really...	「た、大したことじゃないよ……」
「Shall we go, then?」	「それじゃあ、行きましょうか？」	Shall we go, then?	「それじゃあ、行きましょうか？」
「I'll look for the materials another time - you're more important.」	「道具は別の時間に探しに行くわ、あなたのほうが大切だもの」	I'll look for the materials another time - you're more important.	「道具は別の時間に探しに行くわ、あなたの方が大切だもの」
And thus, today marks the day I sold my soul to Monika and her irresistible smile.	というわけで、俺はモニカとその笑顔に魂を売ったのだ。	And thus, today marks the day I sold my soul to Monika and her irresistible smile.	というわけで、俺はモニカとその魅力的な笑顔に魂を売ったのだ。
I timidly follow Monika across the school and upstairs - a section of the school I rarely visit, being generally used for third-year classes and activities.	やれやれと思いながらモニカの後について校舎をわたり階段を上っていく。\n着いたのは、学校の中でも普段は３年生の授業や活動で使用され、自分は滅多に行くことがない場所だった。	I dejectedly follow Monika across the school and upstairs - a section of the school I rarely visit.	やれやれと思いながら、モニカの後について校舎をわたり、階段を上がっていく――着いたのは、学校の中でも滅多に足を踏み入れない場所だった。
Monika, full of energy, swings open the classroom door.	モニカは元気いっぱいに教室のドアを開けた。	Monika, full of energy, swings open the classroom door.	モニカは元気いっぱい、勢いよく教室のドアを開けた。
「I'm back~!」	「ただいま―！」	I'm back~!	「ただいまー！」
「And I brought a guest with me!」	「それとお客さんも連れてきたわよ！」	And I brought a guest with me!	「それとお客さんも連れてきたわよ！」
「Eh?」	「え？」	Eh?	「えっ？」
「A...a guest?」	「お客……さん……？」	A...a guest?	「お客……さん……？」
「Seriously? You brought a boy?」	「正気？ 男子連れて来たわけ？」	Seriously? You brought a boy?	「マジ？ 男子連れて来たわけ？」
「Way to kill the atmosphere.」	「雰囲気ぶち壊しじゃない」	Way to kill the atmosphere.	「雰囲気ぶち壊しじゃない」
「Don't be mean, Natsuki...」	「ナツキ、そんなこといわないの……」	Don't be mean, Natsuki...	「ナツキ、そんなこと言わないの……」
「...But anyway, welcome to the club, [player]!」	「……とにかく[player]君、ようこそ文芸部へ！」	...But anyway, welcome to the club, [player]!	「……とにかく[player]君、ようこそ文芸部へ！」
「...」	「……」	...	「……」
All words escape me in this situation.	つい言葉を失ってしまった。	All words escape me in this situation.	つい言葉を失ってしまった。
This club...	この部活は……	This club...	「この部活は……」
{i}...is full of incredibly cute girls!!{/i}	{i}最高にかわいい子だらけじゃないか！{/i}	<i>...is full of incredibly cute girls!!</i>	<i>……めちゃくちゃかわいい子だらけじゃないか！</i>
「So, let me guess...」	「つまり……」	So, let me guess...	「つまり……」
「You're Monika's boyfriend, right?」	「あんたはモニカの彼氏ってわけ？」	You're Monika's boyfriend, right?	「アンタはモニカの彼氏ってわけ？」
「Wha--」	「えっ……」	Wha--	「えっ……」
「No, I'm not!」	「違う、そうじゃない！」	No, I'm not!	「違う、そうじゃない！」
「Natsuki...」	「ナツキちゃん……」	Natsuki...	「ナツキ……」
The girl with the sour attitude, whose name is apparently Natsuki, is one I don't recognize.	なんだか当たりの強いこの女の子は初めて見る子だ。ナツキというらしい。	The girl with the sour attitude, whose name is apparently Natsuki, is one I don't recognize.	この、何だか当たりの強い女の子は初めて見る子だ。ナツキというらしい。
Her small figure makes me think she's probably a first-year.	小さい容姿からして１年生だろうか。	Her small figure makes her look like a first-year student.	小柄な背丈から、1年生のように見える。
「A-Anyway, this is Natsuki, energetic as usual...」	「と、とにかくこの子がナツキ、いつも元気いっぱいで……」	A-Anyway, this is Natsuki, energetic as usual...	「と、とにかくこの子がナツキ、いつも元気いっぱいで……」
「And this is Yuri, the Vice President!」	「そしてこっちがユリ、副部長なの」	And this is Yuri, the Vice President!	「そしてこっちがユリ、副部長なの！」
「I-It's nice to meet you...」	「よ、よろしくお願いします……」	I-It's nice to meet you...	「よ、よろしくお願いします……」
Yuri, who appears comparably more mature and timid, seems to have a hard time keeping up with someone like Natsuki.	おどおどして、他の子に比べやや大人っぽいこの子はユリというらしい。ナツキのようなタイプと一緒にやっていくのに苦労していそうだ。	Yuri, who appears comparably more mature and timid, seems to have a hard time keeping up with someone like Natsuki.	他の子に比べ、やや大人っぽく、臆病そうでもあるこの子はユリというらしい。ナツキのようなタイプと一緒にやっていくのに苦労していそうだ。
「Yeah... It's nice to meet both of you.」	「ええと、二人ともよろしく」	Yeah... It's nice to meet both of you.	「ええと、二人ともよろしく」
「So, I ran into [player] in a classroom, and he decided to come check out the club.」	「教室で[player]君に会ったから彼、部活を見学することにしたの」	So, I ran into [player] in a classroom, and he decided to come check out the club.	「教室で[player]君に会って、部活を見学してくれることになったの」
「Isn't that great?」	「とっても嬉しいじゃない？」	Isn't that great?	「とってもうれしいでしょ？」
「Wait! Monika!」	「待って！ モニカ！」	Wait! Monika!	「待って！ モニカ！」
「Didn't I tell you to let me know in advance before you brought anyone new?」	「誰か新しい人を連れてくる時はわたしに教えてって言ったわよね？」	Didn't I tell you to let me know in advance before you brought anyone new?	「誰か新しい人を連れてくる時は先に教えてって言ったわよね？」
「I was going to...well, you know...」	「そいつが来ると分かっていたら、わたし……」	I was going to...well, you know...	「そいつが来るってわかってたら、アタシ……」
「Sorry, sorry!」	「ごめん、ごめん」	Sorry, sorry!	「ごめんごめん！」
「I didn't forget that, but I just happened to run into him.」	「忘れた訳じゃないの、彼とはたまたまそこで会ったから……」	I didn't forget that, but I just happened to run into him.	「忘れたわけじゃないの、ただ彼とはたまたまそこで会って……」
「In that case, I should at least make some tea, right?」	「それなら、せめてお茶でも出さないとですね」	In that case, I should at least make some tea, right?	「それなら、せめてお茶でも出さないとですね」
「Yeah, that would be great!」	「それじゃ、お願いするわね！」	Yeah, that would be great!	「それじゃ、お願いするわね！」
「Why don't you come sit down, [player]?」	「[player]君も座ったらどうかしら？」	Why don't you come sit down, [player]?	「[player]君も座ったらどうかしら？」
The girls have a few desks arranged to form a table.	机が並べられて作られたテーブルがある。	The girls have a few desks arranged to form a table.	机を並べてつくったテーブルがある。
Yuri walks to the corner of the room and opens the closet.	ユリは教室の隅まで歩いていきクローゼットを開ける。	Yuri walks to the corner of the room and opens the closet.	ユリは教室の隅まで歩いていき物置を開けた。
Meanwhile, Monika and Natsuki sit across from each other.	その間に、モニカとナツキはお互いに向かい合って座る。	Meanwhile, Monika and Natsuki sit across from each other.	その間に、モニカとナツキはお互いに向かい合って座る。
Still feeling awkward, I take a seat next to Monika.	なんだか未だ気まずさを感じて、俺はとりあえずモニカの隣の席に座る。	Still feeling awkward, I take a seat next to Monika.	未だに気まずさを感じつつも、俺はとりあえずモニカの隣の席に座った。
「So, I know you didn't really plan on coming here...」	「それで、あなたがここにくるつもりじゃなかったのは分かっているけど……」	So, I know you didn't really plan on coming here...	「それで、あなたがここに来るつもりじゃなかったのはわかっているけど……」
「But we'll make sure you feel right at home, okay?」	「でもあなたが居心地がいいって感じられるようにしてみせるから」	But we'll make sure you feel right at home, okay?	「あなたが居心地いいなって感じられるようにしてみせるから」
「As president of the Literature Club, it's my duty to make the club fun and exciting for everyone!」	「文芸部の部長として、部室を楽しくてワクワクするような場所にするのは私の義務だからね！」	As president of the Literature Club, it's my duty to make the club fun and exciting for everyone!	「部室を楽しくワクワクする場所にするのは、文芸部部長としての義務だからね！」
「I'm surprised there aren't more people in the club yet.」	「それにしても部員が少ないことに驚いたよ」	I'm surprised there aren't more people in the club yet.	「それにしても、部員が少ないことに驚いたよ」
「It must be hard to start a new club.」	「新しい部活を始めるのは大変だったろうな」	It must be hard to start a new club.	「新しい部活を始めるのは大変だったろうな」
「You could put it that way.」	「そうかもしれないわね」	You could put it that way.	「そうかもしれないわね」
「Not many people are very interested in putting out all the effort to start something brand new...」	「新しいことを始めることに興味がある人が多いわけではないから……」	Not many people are very interested in putting out all the effort to start something brand new...	「新しいことを始めるのに興味がある人が多いわけではないから……」
「Especially when it's something that doesn't grab your attention, like literature.」	「文学みたいに興味を惹かれないものだと、特にね」	Especially when it's something that doesn't grab your attention, like literature.	「文芸みたいに興味を引かれないものだと、特にね」
「You have to work hard to convince people that you're both fun and worthwhile.」	「みんなに楽しくて価値のあるものだと思わせないといけないわけで」	You have to work hard to convince people that you're both fun and worthwhile.	「みんなに楽しくて価値のあるものだと思わせないといけないから」
「But it makes school events, like the festival, that much more important.」	「そうなると文化祭のようなイベントは更に重要になってくるわね」	But it makes school events, like the festival, that much more important.	「そうなると、文化祭のようなイベントはより重要になってくるわ」
「I'm confident that we can all really grow this club before we graduate!」	「私は卒業するまでにはこの部をみんなでもっと大きくできる自信があるわ」	I'm confident that we can all really grow this club before we graduate!	「私が卒業するまでに、この部をみんなでもっと大きくするの」
「Right, Natsuki?」	「でしょ、みんな？」	Right, Natsuki?	「でしょ、ナツキ？」
「Well...」	「ええ……」	Well...	「今度は……」
「...I guess.」	「……そうね」	...I guess.	「……そうね」
Natsuki reluctantly agrees.	ナツキは仕方なく同意している。	Natsuki reluctantly agrees.	ナツキは仕方なく同意している。
Such different girls, all interested in the same goal...	こんなにも違う女の子たちが、みんな一つの目標を目指しているとは……	Such different girls, all interested in the same goal...	こんなにタイプの異なる女の子たちが、一つの目標を目指しているとは……
Monika must have worked really hard just to find these two.	この２人を集めるのにモニカは相当苦労しただろう。	Monika must have worked really hard just to find these two.	この二人を集めるのだって、モニカは相当苦労しただろう。
Yuri returns to the table, carrying a tea set.	ユリはティーセットを抱えテーブルに戻ってくる。	Yuri returns to the table, carrying a tea set.	ユリはティーセットを抱えてテーブルに戻ってくる。
She carefully places a teacup in front of each of us before setting down the teapot in the middle.	彼女は慎重にみんなの前にティーカップを置き、カップケーキのあるトレイの隣にティーポットを置いた。	She carefully places a teacup in front of each of us before setting down the teapot in the middle.	彼女は慎重にみんなの前にティーカップを置き、真ん中にティーポットを置いた。
「You keep a whole tea set in this classroom?」	「教室にティーセットを置いてるのか？」	You keep a whole tea set in this classroom?	「教室にティーセットを置いてるのか？」
「Don't worry, the teachers gave us permission.」	「大丈夫です、ちゃんと先生方の許可はいただいてますから」	Don't worry, the teachers gave us permission.	「大丈夫です、ちゃんと先生方の許可はいただいてますから」
「After all, doesn't a hot cup of tea help you enjoy a good book?」	「それに、温かいお茶があると読書も捗るでしょう？」	After all, doesn't a hot cup of tea help you enjoy a good book?	「それに、温かいお茶があると読書も捗るでしょう？」
「Ah... I-I guess...」	「ああ……そ、そうだな……」	Ah... I-I guess...	「ああ……そ、そうだな……」
「Ehehe, don't let yourself get intimidated, Yuri's just trying to impress you.」	「えへへ、そんなに怯えなくてもいいわ。ユリはただあなたの関心を引こうとしてるだけよ」	Ehehe, don't let yourself get intimidated, Yuri's just trying to impress you.	「ふふふ、そんなにびくびくしなくてもいいわ。ユリはただあなたの関心を引こうとしてるだけよ」
「Eh?! T-That's not...」	「え、そ、そんなこと……」	Eh?! T-That's not...	「え、そ、そんなこと……」
Insulted, Yuri looks away.	からかわれて、ユリはそっぽを向く。	Insulted, Yuri looks away.	からかわれて、ユリはそっぽを向く。
「I meant that, you know...」	「私はただ、その……」	I meant that, you know...	「私はただ、その……」
「I believe you.」	「分かってるよ」	I believe you.	「わかってるよ」
「Well, tea and reading might not be a pastime for me, but I at least enjoy tea.」	「まあ、お茶を飲みながらの読書は馴染みのない習慣だが、お茶は普通に好きだから」	Well, tea and reading might not be a pastime for me, but I at least enjoy tea.	「まあ、お茶を飲みながら本なんて読まないけどさ、お茶は普通に好きだから」
「I'm glad...」	「良かった……」	I'm glad...	「うれしいです……」
Yuri faintly smiles to herself in relief.	ユリはほっとしたようにかすかに微笑んでいる。	Yuri faintly smiles to herself in relief.	ユリはほっとしたように小さく微笑んだ。
「So, [player], what kinds of things do you like to read?」	「あの、[player]さんは普段どんな本を読まれるんですか？」	So, [player], what kinds of things do you like to read?	「あの、[player]さんは普段どんな本を読まれるんですか？」
「Well... Ah...」	「ええ、ああ……」	Well... Ah...	「ええ、ああ……」
Considering how little I've read these past few years, I don't really have a good way of answering that.	ここ数年ほとんど本を読んでいないので、なんと答えれば良いのか思いつかない。	Considering how little I've read these past few years, I don't really have a good way of answering that.	ここ数年まともに本を読んでいないので、何て答えればいいのかさえ思いつかない。
「...Manga...」	「……マンガ……とか」	...Manga...	「……マンガ……とか」
I mutter quietly to myself, half-joking.	冗談交じりに呟く。	I mutter quietly to myself, half-joking.	冗談交じりに呟く。
Natsuki's head suddenly perks up.	ナツキの頭がピクンと反応した。	Natsuki's head suddenly perks up.	ナツキがピクンと反応した。
It looks like she wants to say something, but she keeps quiet.	何か言いたげだが、黙っている。	It looks like she wants to say something, but she keeps quiet.	何か言いたげだが、黙っている。
「N-Not much of a reader, I guess...」	「あ、あまり読書家ではないのですね……」	N-Not much of a reader, I guess...	「あ、あまり読書家ではないのですね……」
「...Well, that can change...」	「……今後の変化の余地はある……」	...Well, that can change...	「……まあ、変化の余地はあるし……」
What am I saying?	俺は何を言っているんだろう。	What am I saying?	俺は何を言っているんだろう。
I spoke without thinking after seeing Yuri's sad smile.	ユリが悲しそうに笑ってたから考えなしに言ってしまった。	I spoke without thinking after seeing Yuri's sad smile.	ユリが悲しそうに笑っていたから考えなしに言ってしまった。
「Anyway, what about you, Yuri?」	「それより、ユリはどんな本を読むんだ？」	Anyway, what about you, Yuri?	「それよりさ、ユリはどんな本を読むんだ？」
「Well, let's see...」	「ええとですね……」	Well, let's see...	「そうですね……」
Yuri traces the rim of her teacup with her finger.	ユリは指先でティーカップのふちをなぞる。	Yuri traces the rim of her teacup with her finger.	ユリは指先でティーカップのふちをなぞる。
「My favorites are usually novels that build deep and complex fantasy worlds.」	「私は重厚で複雑な世界観を持ったファンタジーが好きなんです」	My favorites are usually novels that build deep and complex fantasy worlds.	「私は重厚で複雑な世界観を持ったファンタジーが好きなんです」
「The level of creativity and craftsmanship behind them is amazing to me.」	「その世界観を支える創造性や職人芸の凄さといったら、目を見張るものがあるんですよ」	The level of creativity and craftsmanship behind them is amazing to me.	「その世界観を支える創造性や職人芸のすごさといったら、目を見張るものがあるんですよ」
「And telling a good story in such a foreign world is equally impressive.」	「そのような異世界で語られる素敵なストーリーもまた、とても感動的なんです」	And telling a good story in such a foreign world is equally impressive.	「そのような異世界で語られるストーリーもまた、とても感動的なんです」
Yuri goes on, clearly passionate about her reading.	ユリは読書について、とても情熱的に語り続けた。	Yuri goes on, clearly passionate about her reading.	ユリは読書について、とても情熱的に語り続けた。
She seemed so reserved and timid since the moment I walked in, but it's obvious by the way her eyes light up that she finds her comfort in the world of books, not people.	俺が入室した瞬間から控えめでおどおどした様子だった彼女の目が急にぱっと明るくなったことから察するに、彼女は人より本の世界に安らぎを見出すのだろう。	She seemed so reserved and timid since the moment I walked in, but it's obvious by the way her eyes light up that she finds her comfort in the world of books, not people.	俺が入室した瞬間から控えめでおどおどした様子だった彼女の目が、急にぱっと明るくなった。彼女は、人より本の世界に安らぎを見出すらしい。
「But you know, I like a lot of things.」	「でもね、他にも様々なものが好きですよ」	But you know, I like a lot of things.	「でも、他にも好きなものはたくさんありますよ」
「Stories with deep psychological elements usually immerse me as well.」	「奥深い心理的要素を含む物語には思わず夢中になってしまいますね」	Stories with deep psychological elements usually immerse me as well.	「奥深い心理描写がつづられた物語には、思わず夢中になってしまいます」
「Isn't it amazing how a writer can so deliberately take advantage of your own lack of imagination to completely throw you for a loop?」	「作家が読者の想像力不足を逆手に取って驚かせにくるなんて凄いですよね？」	Isn't it amazing how a writer can so deliberately take advantage of your own lack of imagination to completely throw you for a loop?	「作家が読者の想像力不足を逆手に取って驚かせにくるなんて、すごいですよね？」
「Anyway, I've been reading a lot of horror lately...」	「でも最近よく読んでるのはホラーなんです……」	Anyway, I've been reading a lot of horror lately...	「ああ、でも最近よく読んでるのはホラーなんです……」
「Ah, I read a horror book once...」	「ああ、ホラーなら俺も一度読んだことがあるな」	Ah, I read a horror book once...	「ああ、ホラーなら俺も一度読んだことがあるよ」
I desperately grasp something I can relate to at the minimal level.	俺は低レベルな自分が乗っかれる話題を必死になってつかむ。	I desperately grasp something I can relate to at the minimal level.	低レベルな自分が乗っかれる話題を必死になってつかもうとする。
At this rate, Yuri might as well be having a conversation with a rock.	こんな調子じゃ、ユリは石とでも会話しておいたほうがマシだ。	At this rate, Yuri might as well be having a conversation with a rock.	こんなんじゃ、ユリは石とでも話している方がマシかもしれない。
「Ahaha. I'd expect that from you, Yuri.」	「あはは。ユリ、あなたらしいわね」	Ahaha. I'd expect that from you, Yuri.	「あはは。ユリ、あなたらしいわね」
「It suits your personality.」	「あなたの性格にぴったりというか」	It suits your personality.	「あなたの性格にぴったりというか」
「Oh, is that so?」	「あら、そうでしょうか」	Oh, is that so?	「あら、そうでしょうか」
「Really, if a story makes me think, or takes me to another world, then I really can't put it down.」	「でも作品に考えさせられたり、異世界に連れて行かれたりすると、本当に止まらなくなってしまいます」	Really, if a story makes me think, or takes me to another world, then I really can't put it down.	「実際、考えさせられたり、異世界に連れて行かれたりする作品は、本当に止まらなくなってしまいます」
「Surreal horror is often very successful at changing the way you look at the world, if only for a brief moment.」	「シュールレアリスムホラーなんて、少しの間だけかもしれませんが、世界の見え方が変わってしまうことだってありますからね」	Surreal horror is often very successful at changing the way you look at the world, if only for a brief moment.	「シュールレアリスムホラーなんて、少しの間だけかもしれませんが、世界の見え方が変わってしまうんですよ」
「Ugh, I hate horror...」	「うう……わたしホラーは苦手……」	Ugh, I hate horror...	「うう……。アタシ、ホラーは苦手……」
「Oh? Why's that?」	「あら、どうしてですか？」	Oh? Why's that?	「あら、どうしてですか？」
「Well, I just...」	「だって、わたし……」	Well, I just...	「だって、アタシ……」
Natsuki's eyes dart over to me for a split second.	ナツキの目が一瞬こちらに向けられた。	Natsuki's eyes dart over to me for a split second.	ナツキの目が一瞬こちらに向けられた。
「Never mind.」	「なんでもない」	Never mind.	「何でもない」
「That's right, you usually like to write about cute things, don't you, Natsuki?」	「確かに、ナツキはかわいいことを書くのが好きだものね。そうでしょ？」	That's right, you usually like to write about cute things, don't you, Natsuki?	「確かに、ナツキはかわいいことを書くのが好きだものね。そうでしょ？」
「W-What?」	「は、はあ？」	W-What?	「は、はあ？」
「What gives you that idea?」	「どうしてそう思うのよ！？」	What gives you that idea?	「何それ、そ、そんなわけないでしょ！？」
「You left a piece of scrap paper behind last club meeting.」	「前の部活の時、ナツキが下書きの紙を置き忘れてて」	You left a piece of scrap paper behind last club meeting.	「前回の部活の時、ナツキが下書きの紙を置き忘れてて」
「It looked like you were working on a poem called--」	「どうやら詩を書いてたみたいね。タイトルは――」	It looked like you were working on a poem called--	「どうやら詩を書いてたみたいね。タイトルは――」
「Don't say it out loud!!」	「読むなー！！」	Don't say it out loud!!	「言うなー！！」
「And give that back!」	「それとその紙返して！」	And give that back!	「あと、その紙返して！」
「Fine, fine~」	「はいはい～」	Fine, fine~	「はいは～い」
「Natsuki, you write your own poems?」	「ナツキって詩を書くのか？」	Natsuki, you write your own poems?	「詩を書くのか？」
「Eh? Well, I guess sometimes.」	「え？ まあ、たまにね」	Eh? Well, I guess sometimes.	「え？ まあ、たまにね」
「Why do you care?」	「なんか問題ある？」	Why do you care?	「何よ、なんか問題ある？」
「I think that's impressive.」	「いやあ、凄いなあって」	I think that's impressive.	「いや、スゴいなあって」
「Why don't you share them sometime?」	「他の人に見せたりしないのか？」	Why don't you share them sometime?	「人に見せたりしないのか？」
「N-No!」	「い、嫌よ！」	N-No!	「し、しないわよ！」
Natsuki averts her eyes.	ナツキは目を逸らした。	Natsuki averts her eyes.	ナツキは目をそらした。
「You wouldn't...like them...」	「そんな……気に入られるようなものでもないし……」	You wouldn't...like them...	「そんな……気に入られるようなものでもないし……」
「Ah...not a very confident writer yet?」	「ああ……まだあまり自信はない感じか」	Ah...not a very confident writer yet?	「ああ……まだあんまり自信はない感じか」
「I understand how Natsuki feels.」	「ナツキちゃんの感じていること、分かります」	I understand how Natsuki feels.	「ナツキちゃんの感じていること、わかります」
「Sharing that level of writing takes more than just confidence.」	「その手の文章を見せるのって、自信以上のものが必要なんですよ」	Sharing that level of writing takes more than just confidence.	「その手の文章を見せるのって、自信以上のものが必要なんですよ」
「The truest form of writing is writing to oneself.」	「自分に向けられた書きものこそが、真の書きものだから」	The truest form of writing is writing to oneself.	「自分に向けられた書きものこそが、真の書きものだから」
「You must be willing to open up to your readers, exposing your vulnerabilities and showing even the deepest reaches of your heart.」	「そういったものを見せる時は、読者に対して心を開いて、自分の弱さを晒し、自分の心の最も深いところすら見せるつもりでいなければいけないのですよ」	You must be willing to open up to your readers, exposing your vulnerabilities and showing even the deepest reaches of your heart.	「そういったものを見せる時は、読者に対して心を開いて、自分の弱さを晒し、心の最も深いところすら見せるつもりでいなければいけないのですよ」
「Do you have writing experience too, Yuri?」	「ユリも執筆の経験があるの？」	Do you have writing experience too, Yuri?	「ユリも執筆の経験があるの？」
「Maybe if you share some of your work, you can set an example and help Natsuki feel comfortable enough to share hers.」	「きっとユリが自分の作品を見せれば、いい見本になって、ナツキが自分のを見せる時に気が楽になるんじゃないかしら？」	Maybe if you share some of your work, you can set an example and help Natsuki feel comfortable enough to share hers.	「ユリが自分の作品を見せれば、いい見本になって、ナツキが自分のを見せる時に気が楽になるんじゃないかしら？」
「...」	「……」	...	「……」
「I guess it's the same for Yuri...」	「どうやらユリもナツキと同じみたいだな」	I guess it's the same for Yuri...	「どうやらユリもナツキと同じみたいだな」
We all sit in silence for a moment.	みんな少しの間黙り込んだ。	We all sit in silence for a moment.	しばしの沈黙。
「Hey, I just got an idea!」	「ねえ、一つ考えがあるわ！」	Hey, I just got an idea!	「そうだ！」
「How about this?」	「こうするのはどう？」	How about this?	「みんな、良い考えがあるわ！」
「...?」	「……？」	...?	「……？」
Natsuki and Yuri look quizzically at Monika.	ナツキとユリはいぶかしげにモニカを見た。	Natsuki and Yuri look quizzically at Monika.	ナツキとユリはいぶかしげにモニカを見た。
「Let's all go home and write a poem of our own!」	「家に帰って、自分の詩を書きましょう！」	Let's all go home and write a poem of our own!	「課題として、詩を書きましょう！」
「Then, next time we meet, we'll all share them with each other.」	「そして、次に会う時に、みんなお互いに見せ合いっこしましょう」	Then, next time we meet, we'll all share them with each other.	「そして次に会う時、お互いに見せ合いっこするの」
「That way, everyone is even!」	「そうすれば、みんな平等でしょ？」	That way, everyone is even!	「そしたら、みんな平等でしょ？」
「U-Um...」	「う、うーん……」	U-Um...	「その……」
「...」	「……」	...	「……」
「Ah...」	「あっ……」	Ah...	「ああ……」
「I mean, I thought it was a good idea...」	「いい考えだと思ったのだけど」	I mean, I thought it was a good idea...	「いい考えだと思ったんだけど……」
「Well...」	「ええ……」	Well...	「その、つまり……」
「...I think you're right, Monika.」	「私もそう思います、モニカちゃん」	...I think you're right, Monika.	「……私もそう思います、モニカちゃん」
「We should probably start finding activities for all of us to participate in together.」	「そろそろみんなで一緒にできる活動を探すべきだと思っていました」	We should probably start finding activities for all of us to participate in together.	「そろそろみんなで一緒にできる活動を探すべきだと思っていました」
「I did decide to take on the responsibility of Vice President, after all...」	「私には副部長としての責任がありますから、やはり……」	I did decide to take on the responsibility of Vice President, after all...	「私には副部長としての責任がありますから、やはり……」
「I need to do my best to nurture the club as well as its members.」	「部活と部員を成長させるために全力を尽くす必要があるので」	I need to do my best to nurture the club as well as its members.	「部活と部員を成長させるために全力を尽くす必要があるので」
「Besides, now that we have a new member...」	「それに、新しい部員も加わったことですし……」	Besides, now that we have a new member...	「それに、新しい部員も加わったことですし……」
「It seems like a good step for us to take.」	「私たちにはちょうど良いステップだと思います」	It seems like a good step for us to take.	「私たちにはちょうど良いステップだと思います」
「Do you agree as well, [player]?」	「あなたもそう思いませんか、[player]さん？」	Do you agree as well, [player]?	「あなたもそう思いませんか、[player]さん？」
「Hold on...there's still one problem.」	「ちょっと待ってくれ……一つ問題がある」	Hold on...there's still one problem.	「ちょっと待ってくれ……一つ問題がある」
「Eh? What's that?」	「え？ なにかしら？」	Eh? What's that?	「え？ 何かしら？」
Now that we've reached the most important topic, I bluntly come forth with what's been on my mind the entire time.	やっと俺が入部する話に戻ってきたところで、ずっと思っていた事をぶっきらぼうに口にする。	Now that we've reached the most important topic, I bluntly come forth with what's been on my mind the entire time.	一番大事な話題が上ったところで、はっきりと口にする。
「I never said I would join this club!」	「俺、入部するなんて一言も言ってないぞ！」	I never said I would join this club!	「俺、入部するなんて一言も言ってないぞ！」
「Monika may have convinced me to stop by, but I never made any decision.」	「モニカに説得されて寄っただけで、まだ何も決めてない」	Monika may have convinced me to stop by, but I never made any decision.	「俺は、モニカに説得されてここに寄っただけで、まだ何も決めてない」
「I still have other clubs to look at, and...um...」	「まだ見学したい部活もあるし、あと……えっと……」	I still have other clubs to look at, and...um...	「まだ見学したい部活もあるし、それにだな、……その……」
I lose my train of thought.	話そうとしていたことが飛んでしまった。	I lose my train of thought.	話そうとしていたことが飛んでしまった。
All three girls stare back at me with dejected eyes.	３人の女の子が失望の眼差しでこっちを見ている。	All three girls stare back at me with dejected eyes.	３人の女の子が、失望の眼差しで俺を見つめるのだ。
「B-But...」	「で、でも……」	B-But...	「そ、そっか……」
「I'm sorry, I thought...」	「ごめんなさい、てっきり……」	I'm sorry, I thought...	「ごめんなさい、てっきり……」
「Hmph.」	「ふん」	Hmph.	「ふん」
「Eh...?」	「えっ……」	Eh...?	「え……？」
The girls exchange glances before Monika turns back to me.	女の子たちが視線を交わし、モニカが俺を見る。	The girls exchange glances before Monika turns back to me.	女の子たちが視線を交わし、モニカが俺を見る。
「I...guess I need to tell you the truth, [player].」	「……本当のことを言わないといけないわね、[player]君」	I...guess I need to tell you the truth, [player].	「……本当のことを言わないといけないわね、[player]君」
「The thing is...」	「実は……」	The thing is...	「あのね……」
「...We don't have enough members yet to form an official club.」	「……私たち、正式な部活動になるにはまだ人数が足りないの」	...We don't have enough members yet to form an official club.	「……私たち、正式な部になるには、まだ人数が足りないの」
「We need four...」	「最低４人は必要で……」	We need four...	「最低４人は必要で……」
「And I've been trying really, really hard to find new members.」	「新しい部員を見つけようと、本当に頑張ってはいるんだけど」	And I've been trying really, really hard to find new members.	「新しい部員を見つけようと、本当にがんばってはいるんだけど」
「And if we don't find one more before the festival...」	「文化祭まであと一人見つけないと……」	And if we don't find one more before the festival...	「文化祭までにあと一人見つけないと……」
「...」	「……」	...	「……」
I...I'm defenseless against these girls.	俺は……俺はこの子たちには無力だ。	I...I'm defenseless against these girls.	こんな表情のこの子たちを前にして……俺は……どうしたらいい？
How am I supposed to make a clear-headed decision when it's like this?	こんな状況で俺が冷静な判断を下せると思うか？	How am I supposed to make a clear-headed decision when it's like this?	こんな状況で物事を冷静に判断できるわけがない。
I would feel terrible for letting everyone down in this situation...	ここでみんなの期待を裏切るのもなんだか悪いし…	I would feel terrible for letting everyone down in this situation...	ここでみんなの期待を裏切るのも何だか悪いし…
And besides, the club itself seems pretty relaxed...	それに、文芸部の活動もまったりとした感じじゃないか…	And besides, the club itself seems pretty relaxed...	それに、文芸部の活動もまったりとしてて良い感じじゃないか…
So, if writing poems is the price I need to pay in order to spend every day with these beautiful girls...	要するに、この子たちと毎日を過ごすために詩を書くことが必要だと言うなら……	So, if writing poems is the price I need to pay in order to spend every day with these beautiful girls...	詩を書けば。ただそれだけで、こんなかわいい子たちと日々を過ごせるのならば……
「...Right.」	「……そうだな」	...Right.	「……それにだ、そう」
「Okay, I've decided, then.」	「よし、決めたよ」	Okay, I've decided, then.	「そう、決めたんだ」
「I'll join the Literature Club.」	「俺は文芸部に入部する！」	I'll join the Literature Club.	「俺は、文芸部に入部する！」
One by one, the girls' eyes light up.	一人ずつ、彼女たちの目が輝く。	One by one, the girls' eyes light up.	彼女たちの目が一斉に輝く。
「Oh my goodness, really?」	「良かった、本当に？」	Oh my goodness, really?	「良かった、本当に？」
「Do you really mean that, [player]?」	「本当に入部してくれるの、[player]？」	Do you really mean that, [player]?	「本当に入部してくれるの、[player]？」
「Yeah...」	「ああ……」	Yeah...	「ああ……」
「It could be fun, right?」	「きっと楽しいだろうしな」	It could be fun, right?	「きっと楽しいだろうしな」
「You really did scare me for a moment...」	「本当にびっくりしたんですよ……？」	You really did scare me for a moment...	「本当にびっくりしたんですよ……？」
「I mean, if you really just left after all this, I would be super pissed.」	「本当にあのまま帰っちゃってたら、超怒ってたんだからね」	I mean, if you really just left after all this, I would be super pissed.	「本当にこのまま帰っちゃってたら、ブッ飛ばしてたんだからね」
「[player], I'm so happy...」	「[player]君、嬉しいわ……」	[player], I'm so happy...	「[player]君、うれしいわ……」
「We can become an official club now!」	「これで私たちも正式な部活になったね！」	We can become an official club now!	「じゃあ、これで私たちも正式な部になったわね！」
「Thank you so much for this. You're really amazing.」	「本当にありがとう、あなたには本当に感謝してるわ」	Thank you so much for this. You're really amazing.	「本当にありがとう、あなたには本当に感謝してるわ」
「I'll do everything I can to give you a great time, okay?」	「あなたが素敵な時間を過ごせるように精一杯お返しするわね」	I'll do everything I can to give you a great time, okay?	「あなたが素敵な時間を過ごせるように精一杯お返しするわね」
「Ah...thanks, I guess.」	「あー、うん……ありがとう」	Ah...thanks, I guess.	「あー、うん……ありがとう」
「Okay, everyone!」	「よし、みんな！」	Okay, everyone!	「よし、みんな！」
「I think with that, we can officially end today's meeting on a good note.」	「これにて今日の部活は終了ね。お疲れさま」	I think with that, we can officially end today's meeting on a good note.	「これにて今日の部活は終了。おつかれさま！」
「Everyone remember tonight's assignment:」	「みんな今日の宿題を忘れないでね」	Everyone remember tonight's assignment:	「さっきの課題、忘れないでね」
「Write a poem to bring to the next meeting, so we can all share!」	「次回の部活で披露できるように、詩を書いて持ってくること！」	Write a poem to bring to the next meeting, so we can all share!	「次回の部活で披露できるように、詩を書いて持ってくること！」
Monika looks over at me once more.	モニカはもう一度こちらに視線を向けた。	Monika looks over at me once more.	モニカはもう一度こちらに視線を向けた。
「[player], I look forward to seeing how you express yourself.」	「[player]君が自分をどう表現するのか、楽しみにしてるわ」	[player], I look forward to seeing how you express yourself.	「[player]君が自分をどう表現するのか、楽しみにしてるわ」
「Ehehe~」	「えへへ～」	Ehehe~	「うふふ」
「Y-Yeah...」	「あ、ああ」	Y-Yeah...	「あ、ああ、うん」
Can I really impress the class star Monika with my mediocre writing skills?	俺なんかの三流の文章力で、クラスのスターだったモニカに良い印象を与えることなんてできるのだろうか？	Can I really impress the class star Monika with my mediocre writing skills?	俺なんかの三流の文章力で、クラスのスターだったモニカに良い印象を与えられるだろうか？
I already feel the anxiety welling up inside me.	俺はすでに不安が湧き上がってくるのを感じていた。	I already feel the anxiety welling up inside me.	早くも不安が押し寄せてくる。
Meanwhile, the girls continue to chit-chat as Yuri cleans up the tea set.	ユリがティーセットを洗っている間も女子達は雑談を続ける。	Meanwhile, the girls continue to chit-chat as Yuri cleans up the tea set.	ユリがティーセットを洗っている間も、女子達はおしゃべりを続けていた。
「I guess I'll be on my way, then...」	「それじゃあ、俺はこの辺で……」	I guess I'll be on my way, then...	「それじゃあ、俺はこの辺で……」
「Okay!」	「オッケー！」	Okay!	「そうだ！」
「I'll see you tomorrow, then.」	「それじゃ、また明日ね」	I'll see you tomorrow, then.	「それじゃ、また明日ね」
「I can't wait!」	「待ちきれないわ！」	I can't wait!	「待ちきれないわ！」
With that, I depart the clubroom and make my way home.	という訳で、俺は部室を出て家に帰る。	With that, I depart the clubroom and make my way home.	というわけで、俺は部室を出て帰路につく。
The whole way, my mind wanders back and forth between the three girls:	道中、俺は何度も３人の女の子のことを思い浮かべる。	The whole way, my mind wanders back and forth between the three girls:	道中、俺は何度も３人の女の子のことを思い浮かべる。
Natsuki,	ナツキ、	Natsuki,	ナツキ、
Yuri,	ユリ、	Yuri,	ユリ、
and, of course, Monika.	そしてもちろん、モニカ。	and, of course, Monika.	そしてもちろん、モニカ。
Will I really be happy spending every day after school in a literature club?	俺は本当に放課後を文芸部で過ごして幸せになれるのだろうか？	Will I really be happy spending every day after school in a literature club?	文芸部生活を通じて、俺は幸せになれるだろうか？
Perhaps I'll have the chance to grow closer to one of these girls...	ひょっとすると誰か一人と親密な関係になれるチャンスが訪れるかもしれない……	Perhaps I'll have the chance to grow closer to one of these girls...	ひょっとして、誰かと親密な関係になれるチャンスが訪れるかも……
Alright!	よし！	Alright!	「了解！」
I'll just need to make the most of my circumstances, and I'm sure good fortune will find me.	この状況をうまく利用して、必ずや幸運を手にしてみせる。	I'll just need to make the most of my circumstances, and I'm sure good fortune will find me.	この状況をうまく利用して、必ずや幸運を手にしてみせる。
And I guess that starts with writing a poem tonight...	その一歩は今夜俺が詩を書くことから始まるのだろう……	And I guess that starts with writing a poem tonight...	その一歩は、今夜俺が詩を書くことから始まるのだろう……
