「Why don't we go ahead and get started?」	「そろそろ始めようか？」	Why don't we go ahead and get started?	「そろそろ始めようか？」
「Yes, let's!」	「はい、ぜひ！」	Yes, let's!	「はい、ぜひ！」
「Actually, I have a request...」	「実は、その前に一つお願いがあるのですが……」	Actually, I have a request...	「実は、その前に一つお願いがあるのですが……」
「...Do you mind if I make some tea first?」	「……先にお茶を淹れても良いですか？」	...Do you mind if I make some tea first?	「……先にお茶を淹れてもいいですか？」
「Not at all.」	「構わないよ」	Not at all.	「もちろん」
「Thanks very much.」	「ありがとうございます」	Thanks very much.	「ありがとうございます」
「If there's one thing that can make my reading time here any better, it's a nice cup of tea.」	「おいしいお茶があるだけで、ここでの読書の時間がより楽しくなるんです」	If there's one thing that can make my reading time here any better, it's a nice cup of tea.	「おいしいお茶があるだけで、ここでの読書の時間がより楽しくなるんです」
「Not to mention for yourself, as well.」	「きっとあなたにとっても」	Not to mention for yourself, as well.	「もちろん、あなたも楽しめると思いますよ」
Yuri stands up and makes her way to the closet.	ユリは立ち上がってクローゼットへ向かった。	Yuri stands up and makes her way to the closet.	ユリは立ち上がって物置へ向かった。
I follow and watch as she retrieves a small water pitcher from the shelf - the kind with a filter inside.	俺はその後について、ユリが小さめのウォーターピッチャーを取り出すのを見守る。中にフィルターが付いているタイプだ。	I follow and watch as she retrieves a small water pitcher from the shelf - the kind with a filter inside.	俺はその後についていき、ユリが小さめのウォーターピッチャーを棚から取り出すのを見守った。中にフィルターが付いているタイプだ。
「Can you hold this for a second?」	「これを少しの間持っていただけませんか？」	Can you hold this for a second?	「ちょっと持っていてもらえませんか？」
「Sure...」	「ああ……」	Sure...	「わかった……」
Yuri hands me the water pitcher and also fetches an electric kettle.	ユリは俺にピッチャーを渡し、さらに棚から電気ケトルを取り出した。	Yuri hands me the water pitcher and also fetches an electric kettle.	ユリは俺にピッチャーを渡すと、棚から電気ケトルを取り出した。
「I'm going to plug this in at the teacher's desk, and then we'll go get some water.」	「これを教卓のコンセントに差してから、お水を入れに行きましょう」	I'm going to plug this in at the teacher's desk, and then we'll go get some water.	「これを教卓のコンセントにつないでから、ピッチャーにお水を入れに行ってきます」
She walks past me and sets the kettle down on the teacher's desk.	ユリは俺を通り過ぎて教卓にケトルを設置した。	She walks past me and sets the kettle down on the teacher's desk.	ユリは俺のそばを通り過ぎると、教卓にケトルを設置した。
I simply watch her movements.	俺は彼女の動作をただ観察する。	I simply watch her movements.	俺は彼女の動作をただ観察する。
To my surprise, the way she moves really contrasts her speaking mannerisms.	驚くことに、彼女の立ち居振る舞いは喋り方とまるで正反対だ。	To my surprise, the way she moves really contrasts her speaking mannerisms.	驚いたことに、彼女の立ち居振る舞いはその話し方とまるで正反対だ。
Especially because of her long legs, Yuri appears elegant and methodical.	脚が長いから余計にユリが上品で整然として見える。	Especially because of her long legs, Yuri appears elegant and methodical.	とりわけその長い脚によって、ユリの姿は優雅で整然として見える。
「Okay, may I have the water pitcher?」	「それでは、ピッチャーをいただいても？」	Okay, may I have the water pitcher?	「それでは、ピッチャーをいただいても？」
「Thanks. I'll be right back.」	「ありがとうございます。すぐ戻ります」	Thanks. I'll be right back.	「ありがとうございます。すぐ戻ります」
「Ah, I might as well walk with you...」	「ああ、どうせなら一緒に行くよ……」	Ah, I might as well walk with you...	「ああ、どうせなら一緒に行くよ……」
「Yeah...why not?」	「はい……あなたがよければ」	Yeah...why not?	「はい……あなたがよければ」
「Shall we go, then?」	「では行きましょうか？」	Shall we go, then?	「それじゃあ、行きましょうか？」
「Yeah...」	「ああ……」	Yeah...	よし……
「Hm? Where are you two off to?」	「あら？ 二人揃ってどこ行くの？」	Hm? Where are you two off to?	「あら？ 二人そろってどこ行くの？」
「Eh?」	「えっ？」	Eh?	「えっ？」
「We're just...Yuri was going to make some tea, so...」	「俺たちは……ユリがこれからお茶を淹れてくれるから……」	We're just...Yuri was going to make some tea, so...	「いやその……ユリがお茶を淹れてくれようとしてて、だから……」
I suddenly realize how weird it sounds to explain this to Monika.	モニカに説明するとなんだか変に思われそうなことに気付く。	I suddenly realize how weird it sounds to explain this to Monika.	俺は不意に、この状況をモニカに説明すると何だか変に思われそうなことに気付いた。
「We're just filling the water pitcher...」	「ピッチャーに水を入れに行くだけだ……」	We're just filling the water pitcher...	「ピッチャーに水を入れに行くだけだ……」
「Ah, okay!」	「あっ、そうだったのね！」	Ah, okay!	「あっ、そうだったのね！」
「Sorry, I was just a bit curious...」	「ごめんなさい、つい気になっちゃって……」	Sorry, I was just a bit curious...	「ごめんなさい、つい気になっちゃって……」
「That's kind of a one-person job, isn't it?」	「だって一人で十分な仕事じゃない？」	That's kind of a one-person job, isn't it?	「だって一人でもできる作業じゃない？」
「That's--」	「それは――」	That's--	「それは――」
「Monika, please mind your own business for once.」	「モニカちゃん、たまには過干渉を控えてください」	Monika, please mind your own business for once.	「モニカちゃん、一度くらい放っておいてくれたらどうなんですか」
「Or do you want to tell me there's something wrong with helping involve [player] in club activities?」	「それとも[player]さんを部活に参加させることに何か異議でも？」	Or do you want to tell me there's something wrong with helping involve [player] in club activities?	「それとも[player]さんが部活動に参加できるよう手伝うことに何か異議でも？」
「E-Eh...?」	「え、えっ……？」	E-Eh...?	「えっ、え……？」
「--!」	「――っ！」	--!	「――っ！」
My mouth gapes.	口があんぐりと開く。	My mouth gapes.	口があんぐりと開く。
「I...」	「私は……」	I...	「アタシは……」
「I suppose there's nothing wrong with that...」	「いえ、なにもないけど……」	I suppose there's nothing wrong with that...	「いえ、特にはないけど……」
「Hmph...」	「ふんっ……」	Hmph...	「ふん……」
「Then let's go, [player].」	「行きましょう、[player]さん」	Then let's go, [player].	「じゃあ行きましょう、[player]さん」
「Ah...」	「あっ……」	Ah...	「あのね……」
Yuri quickly exits the room, and I follow.	ユリはさっさと教室を出て行き、俺も後を追った。	Yuri quickly exits the room, and I follow.	ユリはさっさと教室を出て行き、俺はその後を追った。
Once in the hallway, she suddenly puts her forehead against the wall.	廊下に出るとユリはすぐさま額を壁に押し付けた。	Once in the hallway, she suddenly puts her forehead against the wall.	廊下に出るなり、ユリは突然額を壁に押し付けた。
「I spoke without thinking...」	「考えなしに喋ってしまいました……」	I spoke without thinking...	「考えなしにしゃべってしまいました……」
「How could I say something like that...?」	「私なんであんなことを言ってしまったんでしょう……？」	How could I say something like that...?	「私はなんであんなことを言ってしまったんでしょう……？」
「Yuri...」	「ユリ……」	Yuri...	「ユリ……」
「I just...」	「私は……」	I just...	「アタシはただ……」
「Something about the way she said that...」	「あの言い方に……」	Something about the way she said that...	「彼女の言い方に……」
「It made me feel so...irritated.」	「なぜか……苛立ちを覚えて」	It made me feel so...irritated.	「とても……苛立ちを覚えて」
「What's wrong with me...?」	「私、最低です……」	What's wrong with me...?	「私、どうしちゃったの……？」
「No, Yuri.」	「ユリ、違う」	No, Yuri.	「いいや、ユリ」
「I think...you did the right thing!」	「俺は……ユリが間違ってたと思わない！」	I think...you did the right thing!	「俺は……ユリは正しいことを言ったと思うぞ！」
「I wasn't expecting it, but...」	「確かにびっくりはしたが……」	I wasn't expecting it, but...	「確かにびっくりはしたが……」
「It's also not right for Monika to judge people like that.」	「ああやって人を判断するモニカにも非はある」	It's also not right for Monika to judge people like that.	「ああやって人にケチをつけるモニカにも非はある」
「[player]...」	「[player]さん……」	[player]...	「[player]……」
「How come even when I do something bad...」	「私がひどいことをしても……」	How come even when I do something bad...	「私がひどいことをしても……」
「You're being nice to me?」	「どうしてあなたはずっと優しくしてくれるのですか？」	You're being nice to me?	「どうしてあなたはずっと優しくしてくれるのですか？」
「Because.」	「それは」	Because.	「だってさ」
「Nothing that you do is as bad as you make it seem in your head.」	「ユリが思ってるほど、ユリは悪いことなんかしてないからだ」	Nothing that you do is as bad as you make it seem in your head.	「ユリが思っているほど、ひどいことなんかしてないからだ」
「Nobody's perfect.」	「完璧な人間なんかいないよ」	Nobody's perfect.	「完璧な人間なんかいないよ」
「We have emotions, and we can't always hide them away.」	「人それぞれ感情があるし、それを常に隠すことなんかできない」	We have emotions, and we can't always hide them away.	「人それぞれ感情があるし、それを常に隠すことなんかできない」
「But you always amplify things in your head...」	「でもユリは誇張して考えてしまう癖があるから……」	But you always amplify things in your head...	「でもユリには物事を大げさに考える癖があるから……」
「Your mind turns a light rain shower into a hurricane.」	「まるで小雨も嵐だと考えてそうで」	Your mind turns a light rain shower into a hurricane.	「まるで小雨のことも嵐だと考えてそうだよな」
「Ah...」	「あっ……」	Ah...	「ああ……」
「N-No...」	「い、いえ……」	N-No...	「ち、違う……」
「Wouldn't you hate me for something as terrible as that...?」	「あんなひどいことを言って嫌いになったでしょう……？」	Wouldn't you hate me for something as terrible as that...?	「あんなひどいことを言った私を嫌いにならないんですか……？」
「Why would I hate you?」	「なんで嫌いになるんだよ」	Why would I hate you?	「どうして嫌いになるんだよ」
「I can't hate someone for having emotions...」	「感情を表に出すことの何が悪いんだ？」	I can't hate someone for having emotions...	「感情を表に出すことの何が悪いんだ？」
「What kind of friend would do that?」	「そんなことで友達を嫌ったりなんかしないよ」	What kind of friend would do that?	「そんなことで友達を嫌ったりなんかしないよ」
「Friend...you say?」	「友達……ですか？」	Friend...you say?	「友達……ですか？」
「Ah...um...」	「あっ……えっと……」	Ah...um...	「あっ……えっと……」
Yuri lifts her head.	ユリは顔をあげた。	Yuri lifts her head.	ユリは顔をあげた。
「[player]...」	「[player]さん……」	[player]...	「[player]さん……」
「I really like...being friends with you!」	「私……あなたと友達で良かったです！」	I really like...being friends with you!	「私……あなたと友達で良かったです！」
「Ahaha...」	「はははっ……」	Ahaha...	「そうだな……」
「Thanks, Yuri.」	「ありがとう、ユリ」	Thanks, Yuri.	「ありがとう、ユリ」
「I like being friends with you too...」	「俺もユリと友達でよかった……」	I like being friends with you too...	「俺もユリと友達でよかった……」
I feel kind of awkward saying something like that...	なんだかそう言うのは小っ恥ずかしい……	I feel kind of awkward saying something like that...	そう口に出すと、何だか妙に恥ずかしいい……
But I'm doing my best to help Yuri feel better.	だが今はできるだけユリを慰めてやりたい。	But I'm doing my best to help Yuri feel better.	だが、今はできるだけユリを慰めてやりたい。
「Anyway...!」	「そろそろ……」	Anyway...!	「とにかく……！」
「Ah-- Yeah...」	「あ――はい……」	Ah-- Yeah...	「あ――はい……」
「Shall we go?」	「行きましょうか？」	Shall we go?	「行きましょうか？」
「Yeah.」	「ああ」	Yeah.	「そうね」
Yuri and I walk to the nearest water fountain.	俺とユリは近くの水飲み場まで歩いた。	Yuri and I walk to the nearest water fountain.	俺とユリは近くの水飲み場まで歩いた。
Once we fill up the water pitcher, we return to the classroom.	ピッチャーに水を満タンに入れ、教室へ戻った。	Once we fill up the water pitcher, we return to the classroom.	ピッチャーに水を満タンに入れた俺たちは、教室へ戻った。
「[player], do you like oolong tea?」	「[player]さん、烏龍茶はお好きですか？」	[player], do you like oolong tea?	「[player]さん、烏龍茶はお好きですか？」
「Ah, yeah.」	「ああ」	Ah, yeah.	「えっと、ああ」
「Anything is fine.」	「なんでも構わないよ」	Anything is fine.	「何でも好きだよ」
「Very well.」	「分かりました」	Very well.	「わかりました」
Yuri sets the temperature on the kettle to 200 degrees.	ユリは電気ケトルの温度を100度に調節した。	Yuri sets the temperature on the kettle to 200 degrees.	ユリは電気ケトルの温度を100度に設定した。
「Now it's time to get the teapot.」	「次にティーポットの用意ですね」	Now it's time to get the teapot.	「次はティーポットの用意ですね」
「You really do this properly, don't you?」	「随分凝ってるんだな？」	You really do this properly, don't you?	「ずいぶんと凝るんだな」
「Of course...」	「もちろんです……」	Of course...	「もちろんですよ……」
「I shouldn't do any less when I'm making tea for others.」	「誰かのためなら、より一層丁寧に淹れないと」	I shouldn't do any less when I'm making tea for others.	「誰かのためにお茶を淹れるなら、丁寧にしないと」
「Even if I'm not an expert on tea or anything...?」	「俺がお茶のことをよく分かってなくてもか？」	Even if I'm not an expert on tea or anything...?	「それは俺がお茶のことをよくわかってなくてもか？」
「Huhu.」	「ふふっ」	Huhu.	「ふふっ」
「In that case, you'll only be even more impressed.」	「それならより一層おいしくいただけるかと思いますよ」	In that case, you'll only be even more impressed.	「そうだとしたら、より一層おいしくいただけると思いますよ」
「Ah...perhaps I will!」	「おっ……それもそうだな！」	Ah...perhaps I will!	「ああ……それもそうかもな！」
Yuri fetches the teapot and begins measuring the tea leaves.	ユリはティーポットを取り出すと茶葉を測り始めた。	Yuri fetches the teapot and begins measuring the tea leaves.	ユリはティーポットを取り出すと茶葉の量を測り始めた。
To my surprise, she even starts humming a little to herself.	驚くことに、鼻歌まで歌い始めた。	To my surprise, she even starts humming a little to herself.	驚くことに、小さく鼻歌まで歌い出している。
「You must be in a good mood now...」	「ご機嫌そうだな……」	You must be in a good mood now...	「ご機嫌って感じだな……」
「Is that so?」	「そうですか？」	Is that so?	「ホントに？」
「I was letting it show...」	「わざとそうしてみましたが……」	I was letting it show...	「わざとそうしてみたんですが……」
「And you noticed.」	「ちゃんと気づいてくれましたね」	And you noticed.	「ちゃんと気づいてくれましたね」
「I was doing a bit of thinking...」	「少し考えてみたのですが……」	I was doing a bit of thinking...	「少し考えていたのですが……」
「And I decided that I would try expressing myself a little bit more.」	「もう少しだけ自分の気持ちを表に出していってみようかと思いまして」	And I decided that I would try expressing myself a little bit more.	「もう少しだけ自分の気持ちを表に出していってみようかと思いまして」
「It turns out it's not very hard for me to do...」	「予想よりも難しいことでもなかったようです……」	It turns out it's not very hard for me to do...	「試してみたら、あんまり難しくないということがわかりました……」
「When it's you who's around, anyway.」	「それもきっとあなたがいるからですね」	When it's you who's around, anyway.	「あなたがいてくださる時は、ですけど」
「Ah...」	「そうか！」	Ah...	「なるほど……」
「That's great, Yuri!」	「すごく良い事だと思うぞ、ユリ！」	That's great, Yuri!	「すごく良いことだと思うぞ、ユリ！」
「Just don't push yourself too much.」	「ただ無理はするなよ」	Just don't push yourself too much.	「ただ、無理はするなよ」
「You're always worrying about me, [player]...」	「[player]さんはいつも私の心配をしてくださるのですね……」	You're always worrying about me, [player]...	「[player]さんはいつも私の心配をしてくださるのですね……」
「It's very endearing.」	「そこがとても愛らしいです」	It's very endearing.	「そこがとても魅力的です」
「That's...」	「それは……」	That's...	「それは……」
Yuri wasn't kidding...	ユリの言ったことは本音のようだ……	Yuri wasn't kidding...	ユリは本気で言っているようだ……
I don't even know if I can keep up with this...!	いつまでこの雰囲気が続くんだ……！	I don't even know if I can keep up with this...!	いつまでこの空気が続くんだ……！
I watch Yuri pour a cup of tea for each of us.	とりあえず俺はユリが二人ぶんのお茶を淹れてくれるのを見守る。	I watch Yuri pour a cup of tea for each of us.	とりあえず俺はユリが二人分のお茶を淹れてくれるのを見守る。
「[player], I have another request.」	「[player]さん、もう一つお願いがあります」	[player], I have another request.	「[player]さん、もう一つお願いがあるのですが」
「Do you mind if we sit on the floor today?」	「今日は床に座っても良いですか？」	Do you mind if we sit on the floor today?	「今日は床に座ってもいいですか？」
「Eh? Why's that?」	「えっ？ なんでまた？」	Eh? Why's that?	「一緒に？」
「It's a little bit easier on my back...」	「そうした方が背中が楽なので……」	It's a little bit easier on my back...	「そうした方が、背中が楽なんです……」
「I can read with my back against the wall rather than bending over at my desk.」	「机に前のめりにならず、壁を背もたれにして読めるので」	I can read with my back against the wall rather than bending over at my desk.	「机に前のめりにならず、壁を背もたれにして読めるので」
「Ah, sorry, I didn't realize.」	「ああそうか、気付かなくてすまなかった」	Ah, sorry, I didn't realize.	「ああ、悪い。気付かなかった」
「No worries.」	「いえ、気にしないでください」	No worries.	「いえ、気にしないでください」
「I just have back pain fairly regularly, so I do my best to manage it.」	「よく背中が痛くなってしまうので、予防しておきたくて」	I just have back pain fairly regularly, so I do my best to manage it.	「よく背中が痛くなってしまうので、予防しておきたくて」
「Is that so?」	「そうなのか？」	Is that so?	「そうなのか？」
「I wonder why that is...」	「なんでなんだろうな……」	I wonder why that is...	「何でなんだろうな……」
「It's most likely because my--」	「それはおそらく私の――」	It's most likely because my--	「それはたぶん、私の――」
「Ah--」	「あっ……」	Ah--	「えっと……」
「M-My...」	「わ、私の……」	M-My...	「わ、私の……」
「Your posture, right?」	「姿勢のせいか？」	Your posture, right?	「姿勢のせいか？」
「Always hunched over like that while reading...」	「読書してる時はいつも猫背になってるもんな」	Always hunched over like that while reading...	「読書してる時はいつも猫背になってるもんな……」
「Yes!」	「そ、そうなんです！」	Yes!	「そうです！」
「I have terrible reading posture!」	「私、読書する時の姿勢が本当に悪いんです！」	I have terrible reading posture!	「私、読書する時の姿勢が本当に悪いんです！」
「So that's why we should sit on the floor.」	「だから床に座れたらと思いまして」	So that's why we should sit on the floor.	「だから、床に座れたらと思いまして」
「Fair enough.」	「分かった」	Fair enough.	「わかった」
「I'll go ahead and get the book.」	「それじゃあ本出してくるな」	I'll go ahead and get the book.	「それじゃあ、本を出してくるな」
I retrieve the book from my bag.	俺はカバンから本を取り出した。	I retrieve the book from my bag.	俺はカバンから本を取り出した。
「Ah, I have some chocolate as well...」	「あっ、チョコレートがあるんだった……」	Ah, I have some chocolate as well...	「あっ、チョコレートがあるんだった……」
It's a bag of small chocolate candies that I kept hidden from Sayori's candy radar.	小さなチョコレート菓子が入った袋がある。サヨリのお菓子レーダーから隠し持ってたものだ。	It's a bag of small chocolate candies that I kept hidden from Sayori's candy radar.	それは袋に入った小さなチョコレート菓子だった。
I take it, since it'll go well with the tea.	お茶に合うかと思って、それも取り出した。	I take it, since it'll go well with the tea.	お茶に合うかと思って、それも取り出した。
Yuri and I then sit against the wall, teacups at our sides.	俺とユリはそれぞれティーカップを横に、壁にもたれて座った。	Yuri and I then sit against the wall, teacups at our sides.	俺とユリはそれぞれティーカップを自分の横に置き、壁にもたれて座った。
As if in sync, we assume the same reading position as last time, each holding one half of the book.	気の合うことに、何も言わずとも前回と同じポジションを取り、それぞれの本の端を持った。	As if in sync, we assume the same reading position as last time, each holding one half of the book.	まるでシンクロしているかのように、俺たちは前回と同じ姿勢を取り、それぞれ本の端を持った。
Except this time...	ただ今回は……	Except this time...	ただ今回は……
Our bodies are even closer to each other.	さらに身体の距離が近くなっている。	Our bodies are even closer to each other.	身体の距離がさらに近くなっている。
「I can't see too well...」	「少し見にくいです……」	I can't see too well...	「少し見にくいです……」
「--!」	「――っ！」	--!	「っ！」
Yuri slides closer until our shoulders are touching.	二人の肩が触れ合う距離までユリが接近してきた。	Yuri slides closer until our shoulders are touching.	お互いの肩が触れ合う距離までユリが接近してきた。
How am I supposed to focus on reading like this...?!	この状況でどう読書に集中しろと……！？	How am I supposed to focus on reading like this...?!	この状況でどう読書に集中しろと……！？
Yuri was always kind of cute, but...	ユリってかわいいなあ、と前から思ってはいたが……	Yuri was always kind of cute, but...	常々、ユリってかわいいなあと思ってはいたが……
When she's being less apprehensive, it's almost more than I can handle!	こうも急に積極的になられては俺が耐えられるかどうか……	When she's being less apprehensive, it's almost more than I can handle!	こうも大胆になられては俺が耐えられる限界を越えそうだ！
「Your teacup...」	「ティーカップを……」	Your teacup...	「これ、あなたのティーカップです……」
Yuri hands me my teacup.	ユリが俺のティーカップを手渡してきた。	Yuri hands me my teacup.	ユリが俺のティーカップを手渡してきた。
Holding it with my hand that's not holding the book, I end up in a position that makes it even harder to focus.	空いてる手でそれを受け取ると、俺はさらに集中できない体勢になってしまった。	Holding it with my hand that's not holding the book, I end up in a position that makes it even harder to focus.	本を持っていない空いている手でそれを受け取った俺は、さらに集中できない体勢になってしまった。
Because now I need to worry about making sure I don't accidentally touch her chest...!	誤って胸に触れてしまわないか気を付けねばならないじゃないか……！	Because now I need to worry about making sure I don't accidentally touch her chest...!	間違って胸に触ってしまわないか気を付けないといけなくなるじゃないか……！
Meanwhile, Yuri hasn't noticed a single thing.	一方、ユリは何も気づいていない。	Meanwhile, Yuri hasn't noticed a single thing.	一方、ユリは何も気づいていない。
She wears her intense reading expression, and I can only presume the world around her has faded away.	読書する時のいつもの懸命な顔つきをしている。きっと意識から周りの世界が薄らいでしまっているのだろう。	She wears her intense reading expression, and I can only presume the world around her has faded away.	読書をする時の真剣な顔つきをしている。彼女の周りの世界はフェードアウトしてしまっているのだろうとしか思えなかった。
I use all of my willpower to focus on reading.	俺は読書に集中することに全力で努めた。	I use all of my willpower to focus on reading.	俺は読書に集中することに全力で努めた。
...	……	...	「……」
After a few minutes, I finally manage to relax a little.	数分後、ようやく少し落ち着くことができた。	After a few minutes, I finally manage to relax a little.	数分後、やっと少し落ち着くことができた。
I put the teacup between my legs and fumble with the chocolate wrapper.	俺は脚の間の床にティーカップを置き、チョコの包みをいじくる。	I put the teacup between my legs and fumble with the chocolate wrapper.	脚の間の床にティーカップを置き、チョコの包みをいじくる。
「Ah, sorry...」	「あっ、悪い……」	Ah, sorry...	「あっ、悪い……」
I briefly let go of the book to finish opening the wrapper.	包みを開けるために一瞬、本から手を離す。	I briefly let go of the book to finish opening the wrapper.	包みを開けるために一瞬、本から手を離す。
「You can have as much as you want.」	「好きなだけ食べていいからな」	You can have as much as you want.	「好きなだけ食べていいからな」
「Ah, that's...」	「あ、それは……」	Ah, that's...	「えーっと、その……」
「That's okay, I won't take any...」	「私は結構です……」	That's okay, I won't take any...	「大丈夫です、私はいりません……」
「Eh? Are you sure?」	「えっ？ 本当か？」	Eh? Are you sure?	「えっ？ 本当にいいのか？」
「Well...」	「その……」	Well...	「今度は……」
「If I touch it, then it might get smudges on the pages...」	「チョコレートを触った指で本を触ったら、ページを汚してしまうかと思いまして……」	If I touch it, then it might get smudges on the pages...	「チョコレートを触った指で本に触れたら、ページを汚してしまうかもと思いまして……」
「Ah, you're right...」	「ああ、確かに……」	Ah, you're right...	「ああ、確かに……」
「I didn't even think about that.」	「そこまで配慮が至らなかったよ」	I didn't even think about that.	「そこまで気が回らなかったよ」
「My bad...」	「悪かった」	My bad...	「悪かった……」
「No need to apologize.」	「謝る必要はありませんよ」	No need to apologize.	「謝らなくてもいいですよ」
「I'll hold the book, okay?」	「私が本を持っておきますから、ね？」	I'll hold the book, okay?	「私が本を持っておきますから、ね？」
「Are you sure...?」	「いいのか……？」	Are you sure...?	「いいのか……？」
「Of course.」	「もちろんです」	Of course.	「やりますよ」
Yuri opens the book with both hands.	ユリは両手で本を開いた。	Yuri opens the book with both hands.	ユリは両手で本を開いた。
She holds it so that I don't have any harder of a time reading from it.	俺にも読みやすいように持ってくれている。	She holds it so that I don't have any harder of a time reading from it.	俺にも読みやすいように持ってくれている。
But as a result, her left arm is practically resting on top of my leg.	俺の脚の上に彼女の左腕が乗っかることになってしまったが。	But as a result, her left arm is practically resting on top of my leg.	結果として、俺の脚の上に彼女の左腕が乗ることになってしまったが。
「Well, in that case...」	「それなら……」	Well, in that case...	「まあ、それなら……」
Yuri is already totally focused on reading again.	ユリは再び読書に完全に集中していた。	Yuri is already totally focused on reading again.	すでにユリは、また読書に没頭していた。
I take a chocolate candy and pop it into my mouth.	俺はチョコを一粒取って自分の口にひょいと入れる。	I take a chocolate candy and pop it into my mouth.	俺はチョコを一粒取って自分の口にひょいと入れる。
Then, I take another chocolate...	そしてもう一粒を手に取り……	Then, I take another chocolate...	そして、もう一粒を手に取り……
And I hold it up to Yuri.	ユリの口元へ向けた。	And I hold it up to Yuri.	ユリの方へ持っていった。
She doesn't even look away from the book.	ユリは見向きもしない。	She doesn't even look away from the book.	ユリは本から視線を離すことさえしなかった。
She simply parts her lips, as if this situation was completely natural.	ごく自然な状況であるかのように、唇を少し開けているだけだ。	She simply parts her lips, as if this situation was completely natural.	これがごく自然な状況であるかのように、少し口を開いているだけだ。
But that means I can't stop here!	だがここで止めるわけにはいかない！	But that means I can't stop here!	だがここで止めるわけにはいかない！
I apprehensively place the chocolate in her mouth.	俺はためらいながらも彼女の唇の間にチョコを置くと……	I apprehensively place the chocolate in her mouth.	おそるおそる彼女の唇の間にチョコを差し入れると……
Just like that, Yuri closes her lips over it.	ユリはそのまま唇を閉じ、それを口の中に収めた。	Just like that, Yuri closes her lips over it.	ユリはあっけなく唇を閉じ、それを口の中に収めた。
「Eh...?」	「えっ……？」	Eh...?	「え……？」
Yuri's expression suddenly breaks.	ユリの表情が突然崩れる。	Yuri's expression suddenly breaks.	ユリの表情が突然崩れる。
「Did...」	「い……」	Did...	「い……」
「Did I just...」	「いま、私……」	Did I just...	「今、私……」
Yuri looks at me like she needs to confirm what just happened.	今の出来事を俺に確認するかのようにユリはこちらを見る。	Yuri looks at me like she needs to confirm what just happened.	何が起きたのかを確認するかのように、ユリはこちらを見る。
「U-Um...」	「えっと……」	U-Um...	「その……」
「[player]...」	「[player]さん……」	[player]...	「[player]さん……」
「S-Sorry!」	「わ、悪い！」	S-Sorry!	「わ、悪い！」
「I guess I shouldn't have done that...」	「や、やるべきじゃなかったか……」	I guess I shouldn't have done that...	「こんなこと、しなきゃよかったな……」
「Ah, that's...」	「あ、それは……」	Ah, that's...	「あ、あの……」
「Well...」	「その……」	Well...	「その、つまり……」
「Y-You were just helping...」	「わ、私のことを思っての行動ですよね……？」	Y-You were just helping...	「わ、私のことを思っての行動ですよね……？」
「That's something that...friends do...」	「それが友達の……することだから……」	That's something that...friends do...	「それが友達の……することだから……」
「...Right?」	「……ですよね？」	...Right?	「……ですよね？」
「I mean...」	「それは……」	I mean...	「ここが……」
Not really in this kind of context, but...	これもそういうことだと言えるのか分からないが……	Not really in this kind of context, but...	そういうことだと言えるのかどうか、正直よくわからないが……
「Yeah...」	「そうだな……」	Yeah...	「ああ……」
「...That's all it was.」	「……そういうことだ」	...That's all it was.	「……そういうことだ」
「Yeah...」	「はい……」	Yeah...	「はい……」
「Then...」	「それなら……」	Then...	「それなら……」
「You don't need to stop or anything...」	「や、やめなくても良いんですよ……」	You don't need to stop or anything...	「べ、別に、やめなくても良いんですよ……」
「I-I see...」	「そ、そうか……」	I-I see...	「そ、そうですか……」
The situation has gotten really tense...	かなり張り詰めた空気になってしまった……	The situation has gotten really tense...	かなり緊張した空気になってしまった……
Yuri tries to return to the book.	ユリは読書に戻ろうとする。	Yuri tries to return to the book.	ユリは読書に戻ろうとする。
But I can tell just by her expression that even she can't focus now.	だが表情を見るともはや集中できなくなってしまったのは明らかだ。	But I can tell just by her expression that even she can't focus now.	だがその表情を見ると、もはや集中できなくなってしまったようだ。
My heart is pounding...	心臓がバクバクする……	My heart is pounding...	心臓がバクバクする……
I nervously take another chocolate between my fingers.	俺は緊張した指でチョコをもう一粒とった。	I nervously take another chocolate between my fingers.	俺は落ち着かない気持ちでチョコをもう一粒つまんだ。
But this time, Yuri's eyes meet mine.	次はユリがこちらと目を合わせてきた。	But this time, Yuri's eyes meet mine.	今度は、ユリと目が合った。
「...」	「……」	...	「……」
How did it even come to this...?	どうしてこうなった……	How did it even come to this...?	どうしてこうなった……
Yuri doesn't avert her gaze.	ユリは俺から目を離さない。	Yuri doesn't avert her gaze.	ユリは目を背けない。
I notice her chest rising and falling to the rhythm of her breaths.	吐息のリズムに合わせて胸が上下しているのが見える。	I notice her chest rising and falling to the rhythm of her breaths.	吐息のリズムに合わせて、彼女の胸が上下しているのが見える。
I raise my arm...	俺は腕をあげると……	I raise my arm...	俺が腕をあげると……
「Ah...」	「あ……」	Ah...	「ああ……」
Like before, Yuri parts her lips.	ユリはさっきみたいに口を少し開けた。	Like before, Yuri parts her lips.	ユリはさっきみたいに口を少し開けた。
But...it's different this time.	ただ……今回は少し何か違う。	But...it's different this time.	ただ……今回は何かが違う。
I take the chocolate and place it in her mouth.	俺はチョコを彼女の口の中に入れた。	I take the chocolate and place it in her mouth.	俺はチョコを取ると、彼女の口の中に入れた。
I feel her hot breath on my fingers.	熱い息を指先で感じる。	I feel her hot breath on my fingers.	熱い息を指先で感じる。
「Okay, everyone!」	「よし、みんな！」	Okay, everyone!	「よし、みんな！」
「Uwa--」	「うわっ――」	Uwa--	「うわっ――」
「A-Ah!」	「あ、あっ！」	A-Ah!	「あ、あっ……！」
Yuri jolts back.	ユリがバッと離れる。	Yuri jolts back.	ユリがバッと離れる。
「It's time to share poems!」	「詩の読み合いを始めるわよ！」	It's time to share poems!	「詩の見せ合いっこを始めるわよ！」
「[player], you can help Yuri put away the tea stuff, right?」	「[player]君、ユリのお茶のものを一緒に片付けてあげてくれない？」	[player], you can help Yuri put away the tea stuff, right?	「[player]君、ユリのお茶の道具を片付けるのを手伝ってあげてくれない？」
「Y-Yeah...of course.」	「あ、ああ……もちろん」	Y-Yeah...of course.	「あ、ああ……もちろん」
「Okay, thanks!」	「うん、ありがとう！」	Okay, thanks!	「うん、ありがとう！」
The spell is abruptly broken.	まるで突然魔法が解けてしまったかのようだ。	The spell is abruptly broken.	魔法のような雰囲気は不意に解けてしまった。
「I'll...」	「私は……」	I'll...	「私は……」
「I'll take care of the cups...」	「私はカップを片付けますね……」	I'll take care of the cups...	「私はカップを片付けますね……」
「Yeah...」	「ああ……」	Yeah...	「ああ……」
Yuri picks up the teacups from the floor.	ユリはティーカップを床から拾い上げた。	Yuri picks up the teacups from the floor.	ユリはティーカップを床から拾い上げた。
I pick up the bag of chocolates.	そして俺はチョコレートの袋を拾った。	I pick up the bag of chocolates.	そして俺はチョコレートの袋を拾った。
In the end, we hastily clean up without so much as a word between us.	それ以降、俺たちは特に喋ることもなくさっさと片付けを済ませた。	In the end, we hastily clean up without so much as a word between us.	結局、俺たちは一言も口を利くことなく、さっさと片付けを済ませた。
I get the feeling this is something neither of us will have the courage to bring up...	このことは今後、どちらも恥ずかしすぎて話すことはないだろう……	I get the feeling this is something neither of us will have the courage to bring up...	今後このことを話題にするなんて、どちらも度胸がなくてできないだろう……
