「I've always wondered...」	「ずっと気になってたことがあるんだけど……」	I've always wondered...	「ずっと気になってたことがあるんだけど……」
「What is it about these character archetypes that people find so appealing, anyway?」	「典型的なキャラクターの性格のどこがそんなに魅力的なのかしらね？」	What is it about these character archetypes that people find so appealing, anyway?	「典型的なキャラクターの性格のどこがそんなに魅力的なのかしらね？」
「Their personalities are just completely unrealistic...」	「どの性格も全く現実味がないのに……」	Their personalities are just completely unrealistic...	「どの性格もまったく現実味がないのに……」
「Like, imagine if there was someone like Yuri in real life.」	「だって、もし現実にユリみたいな子がいたら？」	Like, imagine if there was someone like Yuri in real life.	「だって、もし現実にユリみたいな子がいたら？」
「I mean, she's barely even capable of forming a complete sentence.」	「あの子、ろくにまともな文章も喋れないのに」	I mean, she's barely even capable of forming a complete sentence.	「あの子、ろくにまともな文章もしゃべれないのに」
「And forget about Natsuki...」	「ナツキなんか論外だし……」	And forget about Natsuki...	「ナツキなんか論外だし……」
「Sheesh.」	「まったく……」	Sheesh.	「まったく……」
「Someone with her kind of personality doesn't just get all cute and pouty whenever things don't go her way.」	「あんな性格の子は、思い通りにいかなかったら可愛く拗ねたりなんかしないわ」	Someone with her kind of personality doesn't just get all cute and pouty whenever things don't go her way.	「あんな性格の子は、思い通りにいかなかったらかわいく拗ねたりなんかしないわ」
「I could go on, but I think you get the point...」	「まだ言いたいことはあるけど、わかるでしょ？」	I could go on, but I think you get the point...	「まだ言いたいことはあるけど、わかるでしょ？」
「Are people really attracted to these weird personalities that literally don't exist in real life?」	「本当に人はあんな現実ではあり得ないような性格に惹かれるの？」	Are people really attracted to these weird personalities that literally don't exist in real life?	「本当に人は、あんな現実ではあり得ないような性格に引かれるの？」
「I'm not judging or anything!」	「批判するつもりじゃなくて！」	I'm not judging or anything!	「批判するつもりじゃなくて！」
「After all, I've found myself attracted to some pretty weird stuff, too...」	「私だって変なものに惹かれることだってあったし……」	After all, I've found myself attracted to some pretty weird stuff, too...	「私だって変なものに引かれることだってあったし……」
「I'm just saying, it fascinates me.」	「ただ、面白いなあって思うだけ」	I'm just saying, it fascinates me.	「ただ、面白いなあって思うだけ」
「It's like you're siphoning out all the components of a character that makes them feel human, and leaving just the cute stuff.」	「キャラクターに人間味を与える特徴を全部吸い出して、かわいいものだけを残してるみたいじゃない」	It's like you're siphoning out all the components of a character that makes them feel human, and leaving just the cute stuff.	「キャラクターに人間味を与える特徴を全部吸い出して、かわいいものだけを残してるみたいじゃない」
「It's concentrated cuteness with no actual substance.」	「それって中身のない可愛さが凝縮されたようなものよね」	It's concentrated cuteness with no actual substance.	「それって中身のないかわいさが凝縮されたようなものよね」
「...You wouldn't like me more if I was like that, right?」	「……私もそうした方がもっと好きになったりしないわよね？」	...You wouldn't like me more if I was like that, right?	「……私もそんな風だったら、もっと好きになってくれたりしないわよね？」
「Maybe I just feel a little insecure because you're playing this game in the first place.」	「そもそもこのゲームを遊んでるからちょっと不安に思ってるのかもしれないわ」	Maybe I just feel a little insecure because you're playing this game in the first place.	「そもそも、あなたがこのゲームを遊んでるからちょっと不安に思ってるのかもしれないわ」
「Then again, you're still here with me, aren't you...?」	「でも、あなたは今もここにいるものね……？」	Then again, you're still here with me, aren't you...?	「でも、あなたは今もここにいるものね……？」
「I think that's enough reason for me to believe I'm okay just the way I am.」	「それだけでも、私はこのままで良いって思える充分な理由よね」	I think that's enough reason for me to believe I'm okay just the way I am.	「それだけでも、私はこのままの私で良いって思える十分な理由」
「And by the way, you are too, [player].」	「あなたもそうよ、[player]君」	And by the way, you are too, [player].	「あなたもそうよ、[player]君」
「You're the perfect combination of human and cuteness.」	「あなたは人間らしさと可愛らしさの完璧な結合体だもの」	You're the perfect combination of human and cuteness.	「あなたは人間らしさと可愛らしさの完璧な結合体だもの」
「That's why there was never a chance I wouldn't fall for you.」	「だからあなたを好きになるのも必然だったのよ」	That's why there was never a chance I wouldn't fall for you.	「だからあなたを好きになるのも必然だったのよ」
