「Phew...」	「ふう……」	Phew...	「ふぅ……」
I guess that's everyone.	これで全員かな。	I guess that's everyone.	これで全員かな。
I glance around the room.	部屋を見回してみる。	I glance around the room.	部屋を見回してみる。
That was a little more stressful than I anticipated.	思ったよりプレッシャーが大きかった。	That was a little more stressful than I anticipated.	思ったよりプレッシャーが大きかった。
It's as if everyone is judging me for my mediocre writing abilities...	まるで俺の文章力の平凡さを査定されているかのような……	It's as if everyone is judging me for my mediocre writing abilities...	まるで俺の文章力の平凡さを査定されているかのような……
Even if they're just being nice, there's no way my poems can stand up to theirs.	良いように言ってくれてたとしても、俺の詩がみんなの出来に届くはずがないのだ。	Even if they're just being nice, there's no way my poems can stand up to theirs.	良いように言ってくれてたとしても、俺の詩がみんなの出来に届くはずがないのだ。
This is a literature club, after all.	なんてったって文芸部なのだから。	This is a literature club, after all.	なんてったって文芸部なのだから。
I sigh.	ため息をつく。	I sigh.	ため息をつく。
I guess that's what I ended up getting myself into.	俺が首を突っ込んだのはこういう場所だったようだ。	I guess that's what I ended up getting myself into.	とんでもないところに首を突っ込んでしまったようだ。
Across the room, Sayori and Monika are happily chatting.	部屋の向こうでは、サヨリとモニカが楽しそうにおしゃべりをしている。	Across the room, Sayori and Monika are happily chatting.	向こうの方で、サヨリとモニカが楽しそうにおしゃべりをしている。
My eyes land on Yuri and Natsuki.	ユリとナツキに目をやる。	My eyes land on Yuri and Natsuki.	ユリとナツキに目をやる。
They gingerly exchange sheets of paper, sharing their respective poems.	彼女らはそろそろと紙を交換しあい、それぞれの詩を見せている。	They gingerly exchange sheets of paper, sharing their respective poems.	彼女らはそろそろと紙を交換し合い、それぞれの詩を見せ合っている。
As they read in tandem, I watch each of their expressions change.	並んで詩を読みながら、二人の表情が変わっていく様子が見て取れる。	As they read in tandem, I watch each of their expressions change.	並んで詩を読みながら、二人の表情が変わっていく様子が見て取れる。
Natsuki's eyebrows furrow in frustration.	ナツキは苛立ったように眉間にしわを寄せる。	Natsuki's eyebrows furrow in frustration.	ナツキは苛立ったように眉間にしわを寄せる。
Meanwhile, Yuri smiles sadly.	一方、ユリは悲しそうに微笑む。	Meanwhile, Yuri smiles sadly.	一方、ユリは悲しそうに微笑む。
「<i>(What's with this language...?)</i>」	<i>（何なのよこの言い回し……？）</i>	<i>(What's with this language...?)</i>	<i>（何なのよ、この言い回し……！？）</i>
「Eh?」	「えっ？」	Eh?	「えっ？」
「Um...did you say something?」	「あの……何か言いましたか？」	Um...did you say something?	「あの……何か言いましたか？」
「Oh, it's nothing.」	「いや、何でもないわ」	Oh, it's nothing.	「いや、何でもないわ」
Natsuki dismissively returns the poem to the desk with one hand.	ナツキは持っていた詩を素っ気なく片手で机の上に置いた。	Natsuki dismissively returns the poem to the desk with one hand.	ナツキは持っていた詩を素っ気なく片手で机の上に置いた。
「I guess you could say it's fancy.」	「しゃれた感じなんじゃない」	I guess you could say it's fancy.	「しゃれた感じなんじゃない」
「Ah-- Thanks...」	「あ、ありがとうございます……」	Ah-- Thanks...	「あ、ありがとうございます……」
「Yours is...cute...」	「あなたのは……かわいいですね……」	Yours is...cute...	「あなたのは……かわいいですね……」
「Cute?」	「かわいい？」	Cute?	「かわいい？」
「Did you completely miss the symbolism or something?」	「まさか何を象徴しているのか何にも気づかなかったってわけ？」	Did you completely miss the symbolism or something?	「まさか、何を象徴してるのかまったく気づかなかったってわけ？」
「It's clearly about the feeling of giving up.」	「どう見たって諦めの心情についてでしょ」	It's clearly about the feeling of giving up.	「どう見たって諦めの心情についてでしょ」
「How can that be cute?」	「どうしたらかわいく見えるのよ？」	How can that be cute?	「どうしたらかわいく見えるのよ？」
「I-I know that!」	「わ、分かってます！」	I-I know that!	「わ、わかってます！」
「I just meant...」	「ただ私が言いたいのは……」	I just meant...	「ただ私が言いたいのは……」
「The language, I guess...」	「その、言葉選びとか……」	The language, I guess...	「その、言葉選びとか……」
「I was trying to say something nice...」	「気の利いたことを言えたら良かったんですけど……」	I was trying to say something nice...	「気の利いたことを言えたら良かったんですけど……」
「Eh?」	「はあ？」	Eh?	「はっ？」
「You mean you have to try that hard to come up with something nice to say?」	「つまり気の利いたことを言うのにそんなに苦労する作品だっていうのね」	You mean you have to try that hard to come up with something nice to say?	「つまり気の利いたことを言うのにそんなに苦労する作品だっていうのね」
「Thanks, but it really didn't come out nice at all!」	「結構結構、でも気なんて全然利いてなかったわ！」	Thanks, but it really didn't come out nice at all!	「結構結構、でも気なんて全然利いてなかったわ！」
「Um...」	「えっと……」	Um...	「その……」
「Well, I do have a couple suggestions...」	「その、いくつか提案したいことがあるのですが……」	Well, I do have a couple suggestions...	「その、いくつか提案したいことがあるのですが……」
「Hmph.」	「ふん」	Hmph.	「ふん」
「If I was looking for suggestions, I would have asked someone who actually liked it.」	「詩を気に入ってくれた人の提案なら、聞いてあげないこともなかったけどね」	If I was looking for suggestions, I would have asked someone who actually liked it.	「詩を気に入ってくれた人の提案なら、聞いてあげないこともなかったけどね」
「Which people <i>did</i>, by the way.」	「実際そういう人は<i>ちゃんと</i>いるんだし」	Which people <i>did</i>, by the way.	「実際そういう人は<i>ちゃんと</i>いるんだし」
「Sayori liked it.」	「サヨリとか」	Sayori liked it.	「サヨリとか」
「And [player] did, too!」	「それに[player]だって！」	And [player] did, too!	「それに[player]だって！」
「So based on that, I'll gladly give you some suggestions of my own.」	「それに、そもそもわたしからも是非提案したいことがあるわ」	So based on that, I'll gladly give you some suggestions of my own.	「それに、そもそもアタシからもぜひ提案したいことがあるわ」
「First of all--」	「まずねえ……」	First of all--	「まずねえ……」
「Excuse me...」	「すみません、あの……」	Excuse me...	「すみません、あの……」
「I appreciate the offer, but I've spent a long time establishing my writing style.」	「折角なのですが、この文体を確立するために私は長い時間をかけてきたんです」	I appreciate the offer, but I've spent a long time establishing my writing style.	「折角なのですが、この文体を確立するために私は長い時間をかけてきたんです」
「I don't expect it to change anytime soon, unless of course I come across something particularly inspiring.」	「心を突き動かす何かに出会わない限りは、しばらくこのまま変わらないと思います」	I don't expect it to change anytime soon, unless of course I come across something particularly inspiring.	「心を突き動かす何かに出会わない限りは、しばらくこのまま変わらないと思います」
「Which I haven't yet.」	「そういうものにはまだ出会えていないのですけどね」	Which I haven't yet.	「そういうものにはまだ出会えていないのですけどね」
「Nn...!」	「なっ……！」	Nn...!	「なっ……！」
「And [player] liked my poem too, you know.」	「それに[player]さんは私の詩も気に入って下さったみたいですよ」	And [player] liked my poem too, you know.	「それに[player]さんは私の詩も気に入ってくださったみたいですよ」
「He even told me he was impressed by it.」	「感動したとまで言ってくださいましたし」	He even told me he was impressed by it.	「感動したとまで言ってくださいましたし」
Natsuki suddenly stands up.	ナツキは突然席を立った。	Natsuki suddenly stands up.	ナツキは突然席を立った。
「Oh?」	「なによ？」	Oh?	「あら」
「I didn't realize you were so invested in trying to impress our new member, Yuri.」	「ユリってば新入部員とお近づきになりたくて必死だったなんて気がつかなかったわ」	I didn't realize you were so invested in trying to impress our new member, Yuri.	「ユリってば、新入部員とお近づきになりたくて必死だったなんて気がつかなかったわ」
「E-Eh?!」	「え、ええっ！？」	E-Eh?!	「え、えっ！？」
「That's not what I...!」	「そういうわけでは……！」	That's not what I...!	「そういうわけでは……！」
「Uu...」	「うう……」	Uu...	「うう……」
「You...You're just...」	「あ、あなただって……」	You...You're just...	「あ、あなただって……」
Yuri stands up as well.	ユリも同じように席を立つ。	Yuri stands up as well.	ユリも同じように席を立つ。
「Maybe you're just jealous that [player] appreciates my advice more than he appreciated yours!」	「あなただって[player]さんがあなたより私のアドバイスを尊重したことに嫉妬してるのではないですか！？」	Maybe you're just jealous that [player] appreciates my advice more than he appreciated yours!	「あなただって[player]さんがあなたより私のアドバイスを尊重したことに嫉妬しているのではないですか！？」
「Huh! And how do you know he didn't appreciate <i>my</i> advice more?」	「はん！ で、どうやってわたしのアドバイスより有難がってるって分かるのよ？」	Huh! And how do you know he didn't appreciate <i>my</i> advice more?	「はん！ 何で<i>アタシの</i>アドバイスよりありがたがってるってわかるのよ？」
「Are you that full of yourself?」	「調子に乗りすぎなんじゃないの？」	Are you that full of yourself?	「調子に乗りすぎなんじゃない？」
「I...!」	「私は……！」	I...!	「……もしですよ！」
「No...」	「違う……」	No...	「いいえ……」
「If I was full of myself...」	「私が調子に乗っていたのなら……」	If I was full of myself...	「調子に乗っていたのなら……」
「...I would deliberately go out of my way to make everything I do overly cutesy!」	「私だってわざとらしくぶりっ子してますよ！」	...I would deliberately go out of my way to make everything I do overly cutesy!	「私だってわざとらしく、かわいこぶりっ子してますよ！」
「Uuuuuu...!」	「うううぐぐぐぐ……！」	Uuuuuu...!	「うぐぐぐぐ……！」
「U-Um!!」	「あの、えっと！！」	U-Um!!	「あの、えっと！！」
「Is everyone okay...?」	「みんな大丈夫……？」	Is everyone okay...?	「ね、落ち着いて……？」
「Well, you know what?!」	「じゃあ言うけどね！」	Well, you know what?!	「じゃあ言うけどね！」
「I wasn't the one whose boobs magically grew a size bigger as soon as [player] started showing up!!」	「[player]が入ってから突然胸をワンサイズ盛りだしたのはどっちよ？！」	I wasn't the one whose boobs magically grew a size bigger as soon as [player] started showing up!!	「[player]が入ってから突然胸をワンサイズ盛りだしたのはどこのどいつよ！？」
「N-Natsuki!!」	「な、ナツキちゃん！！」	N-Natsuki!!	「な、ナツキちゃん！！」
「Um, Natsuki, that's a little--」	「えっとナツキ、それはちょっと――」	Um, Natsuki, that's a little--	「えっとナツキ、それはちょっと――」
「This doesn't involve you!」	「部外者は黙ってて！」<br>「部外者は黙っててください！」	This doesn't involve you!	「「部外者は黙ってて！」ください！」
「I-I don't like fighting, guys...!」	「け、ケンカはダメだよ、みんな……！」	I-I don't like fighting, guys...!	「ふ、二人とも、ケンカはダメだよ……！」
Suddenly, both girls turn towards me, as if they just noticed I was standing there.	突然二人は、俺がそこにいることに今気づいたようにこちらへ振り向いた。	Suddenly, both girls turn towards me, as if they just noticed I was standing there.	突然二人は、俺の存在に今気づいたかのようにこちらへ振り向いた。
「[player]...!」	「[player]さん……！」	[player]...!	「[player]さん……！」
「She-- She's just trying to make me look bad...!」	「こ、この子が私の印象を悪くしようとしてるだけなんです……！」	She-- She's just trying to make me look bad...!	「こ、この子が私の印象を悪くしようとしてるだけなんです……！」
「That's not true!」	「違うでしょ！」	That's not true!	「違うでしょ！」
「She started it!」	「そっちが始めたんでしょうが！」	She started it!	「そっちが始めたんでしょうが！」
「If she could get over herself and learn to appreciate that <i>simple</i> writing is more effective...」	「もしユリが偏屈な態度を改めて、素直な文が一番効果的だって受け入れていれば……」	If she could get over herself and learn to appreciate that <i>simple</i> writing is more effective...	「もしユリが偏屈な態度を改めて、<i>素直な</i>文が一番効果的だって受け入れていれば……」
「Then this wouldn't have happened in the first place!」	「最初からこんなことにはならなかったのよ！」	Then this wouldn't have happened in the first place!	「最初からこんなことにはならなかったのよ！」
「What's the point in making your poems all convoluted for no reason?」	「なんであんたはいつも意味もなくややこしい文章にしちゃうのよ」	What's the point in making your poems all convoluted for no reason?	「なんでアンタはいつも意味もなくややこしい文章にしちゃうのよ」
「The meaning should jump out at the reader, not force them to have to figure it out.」	「趣旨ってのは考察させるものじゃなくて、読者の元へ飛び込むようなものであるべきなの」	The meaning should jump out at the reader, not force them to have to figure it out.	「趣旨ってのは考察させるものじゃなくて、読者の元へ飛び込むようなものであるべきなの」
「Help me explain that to her, [player]!」	「[player]もユリに説明してあげて！」	Help me explain that to her, [player]!	「[player]もユリに説明してあげて！」
「W-Wait!」	「ま、待ってください！」	W-Wait!	「ま、待ってください！」
「There's a reason we have so many deep and expressive words in our language!」	「私たちの言葉に表現豊かで奥深いものが多いのには理由があるんですよ」	There's a reason we have so many deep and expressive words in our language!	「私たちの言葉に表現豊かで奥深いものが多いのには、理由があるんですよ！」
「It's the only way to convey complex feelings and meaning the most effectively.」	「入り組んだ感情や意味合いを伝えるにはそれしか方法がないですから」	It's the only way to convey complex feelings and meaning the most effectively.	「入り組んだ感情や意味合いを伝えるにはそれしか方法がないですから」
「Avoiding them is not only unnecessarily limiting yourself...it's also a waste!」	「折角のそれを避けてしまうだなんて、不必要に言葉を縛るどころか……無駄にしています！」	Avoiding them is not only unnecessarily limiting yourself...it's also a waste!	「折角のそれを避けてしまうだなんて、不必要に言葉を縛るどころか……無駄にしています！」
「You understand that, right, [player]?」	「あなたもそう思いますよね、[player]さん？」	You understand that, right, [player]?	「あなたもそう思いますよね、[player]さん？」
「Um...!」	「えええ……！」	Um...!	「えっ……！」
「Well??」	「どうなの？？」	Well??	「どうなの？？」
「...」	「……」	...	「……」
How did I get dragged into this in the first place?!	そもそもどうして俺が巻き込まれてるんだ！？	How did I get dragged into this in the first place?!	そもそもどうして俺が巻き込まれてるんだ！？
It's not like I know anything about writing...	書き物について特に詳しいわけでもないのに……	It's not like I know anything about writing...	書き物について特に詳しいわけでもないのに……
But whomever I agree with, they'll probably think more highly of me!	でもどっちかに俺が賛成したら、きっとその子からは評価されるはずだ！	But whomever I agree with, they'll probably think more highly of me!	でもどっちかに俺が賛成したら、きっとその子からは評価されるはずだ！
So, of course that's going to be...!	だから、それはもちろん……！	So, of course that's going to be...!	だから、それはもちろん……！
Natsuki.	ナツキ	Natsuki.	ナツキ
Yuri.	ユリ	Yuri.	ユリ
Help me, Sayori!!	助けて、サヨリ！！	Help me, Sayori!!	助けて、サヨリ！！
「Okay, everyone!」	「よし、みんな！」	Okay, everyone!	「よし、みんな！」
「It's just about time for us to leave.」	「そろそろ時間のようね」	It's just about time for us to leave.	「そろそろ時間のようね」
「How did you all feel about sharing poems?」	「詩を交換してみてどうだった？」	How did you all feel about sharing poems?	「詩を交換してみてどうだった？」
「It was a lot of fun!」	「すごく楽しかったよ！」	It was a lot of fun!	「すごく楽しかったよ！」
「Well, I'd say it was worth it.」	「ええ、やってみる価値はあったと思います」	Well, I'd say it was worth it.	「ええ、やってみる価値はあったと思います」
「It was alright. Well, mostly.」	「良かったわ。まあ、そこそこ」	It was alright. Well, mostly.	「良かったわ。まあ、そこそこ」
「[player], how about you?」	「[player]君はどうだった？」	[player], how about you?	「[player]君はどうだった？」
「...Yeah, I'd say the same.」	「……ああ、同じく」	...Yeah, I'd say the same.	「……ああ、同じく」
「It was a neat thing to talk about with everyone.」	「みんなと交流するのには面白い題材だったよ」	It was a neat thing to talk about with everyone.	「みんなと交流するのには面白い題材だったよ」
「Awesome!」	「良かった！」	Awesome!	「良かった！」
「In that case, we'll do the same thing tomorrow.」	「それなら、明日もやってみよっか」	In that case, we'll do the same thing tomorrow.	「それなら、明日もやってみよっか」
「And maybe you learned something from your friends, too.」	「あなたもみんなから何かを学び取れたかもしれないでしょ」	And maybe you learned something from your friends, too.	「あなたもみんなから何かを学び取れたかもしれないでしょ」
「So your poems will turn out even better!」	「きっとより素敵な詩が書けるはずよ！」	So your poems will turn out even better!	「きっとより素敵な詩が書けるはずよ！」
「...」	「……」	...	「……」
I think to myself.	俺は考える。	I think to myself.	俺は考える。
I did learn a little more about the kinds of poems everyone likes.	みんながどういう系統の詩が好みなのか少し分かってきた。	I did learn a little more about the kinds of poems everyone likes.	みんながどういう系統の詩が好みなのか少しずつわかってきた。
With any luck, that means I can at least do a better job impressing those I want to impress.	運が良ければ、気になる人が感銘を受けてくれるようなものが作れるかもしれない。	With any luck, that means I can at least do a better job impressing those I want to impress.	運が良ければ、気になる人が感銘を受けてくれるようなものがつくれるかもしれない。
I nod to myself with newfound determination.	新たな決意を抱きつつ、俺は頷いた。	I nod to myself with newfound determination.	新たな決意を抱きつつ、俺はうなずいた。
「[player]!」	「[player]！」	[player]!	「[player]！」
「Ready to walk home?」	「帰りの支度できた？」	Ready to walk home?	「帰りの支度できた？」
「Sure, let's go.」	「ああ、行こっか」	Sure, let's go.	「ああ、行こっか」
「Ehehe~」	「えへへ～」	Ehehe~	「うふふ」
Sayori beams at me.	サヨリはニコニコしている。	Sayori beams at me.	サヨリはニコニコしている。
It truly has been a while since Sayori and I have spent this much time together.	サヨリと俺がこうやって一緒に過ごすのは随分久しぶりのことだった。	It truly has been a while since Sayori and I have spent this much time together.	サヨリとこうやって一緒に過ごすのは、ずいぶん久しぶりのことだった。
I can't really say I'm not enjoying it, either.	決して、俺も楽しんでない訳ではない。	I can't really say I'm not enjoying it, either.	決して、俺も楽しんでないわけではない。
「Sayori...」	「サヨリ……」	Sayori...	「……サヨリ……」
「About what happened earlier...」	「さっきの事なんだけどさ……」	About what happened earlier...	「さっきのことなんだけどさ……」
「Eh? What do you mean?」	「え？ なんのこと？」	Eh? What do you mean?	「え？ どしたの？」
「You know, between Yuri and Natsuki.」	「あー、ユリとナツキのことだ」	You know, between Yuri and Natsuki.	「あの、ユリとナツキのことだ」
「Does that kind of thing happen often?」	「ああいうことってよくあるのか？」	Does that kind of thing happen often?	「ああいうことってよくあるのか？」
「No, no, no!」	「ないないない！」	No, no, no!	「ないないない！」
「That's really the first time I've seen them fight like that...」	「あんなにケンカしてるのはわたしも初めて見たよ……」	That's really the first time I've seen them fight like that...	「あんなにケンカしてるのはわたしも初めて見たよ……」
「I promise they're both wonderful people.」	「二人ともほんと素敵な子だよ」	I promise they're both wonderful people.	「二人とも、ホント素敵な子だよ」
「You don't... You don't hate them, do you??」	「二人のこと……嫌いになんかなってない、よね？」	You don't... You don't hate them, do you??	「二人のこと……嫌いになんかなってない、よね？」
「No, I don't hate them!」	「そんな、全然嫌ってないぞ！」	No, I don't hate them!	「そんな、全然嫌ってないぞ！」
「I just wanted your opinion, that's all.」	「俺はただお前の意見を聞いてみたかっただけだ」	I just wanted your opinion, that's all.	「ただ、お前の意見を聞いてみたかっただけだよ」
「I can see why they'd make good friends with you.」	「あいつらがお前とウマが合いそうだってのは分かるんだ」	I can see why they'd make good friends with you.	「あいつらがお前とウマが合いそうだってのは、わかるんだ」
「Phew...」	「ふー……」	Phew...	「ふぅ……」
「You know, [player]...」	「あのね、[player]……」	You know, [player]...	「あのね、[player]……」
「It's nice that I get to spend time with you in the club.」	「わたし、[player]と一緒に部活できて嬉しい」	It's nice that I get to spend time with you in the club.	「わたし、[player]と一緒に部活できてうれしい」
「But I think seeing you get along with everyone is what makes me the happiest.」	「でもみんなと打ち解けてく[player]を見てるのが、わたしの一番の幸せなの」	But I think seeing you get along with everyone is what makes me the happiest.	「でもみんなと打ち解けてく[player]を見てるのが、わたしの一番の幸せなの」
「And I think everyone really likes you, too!」	「みんな、[player]のことがすっごく好きなんだもん！」	And I think everyone really likes you, too!	「みんな、[player]のことがすっごく好きなんだもん！」
「That's--!」	「それって――！」	That's--!	「えっ――！」
「Ehehe~」	「えへへ～」	Ehehe~	「うふふ」
「Every day is going to be so much fun~」	「毎日がどんどん楽しくなっちゃいそう～」	Every day is going to be so much fun~	「毎日がどんどん楽しくなっちゃいそ～」
「Sigh...」	「はあ……」	Sigh...	「はあ……」
It looks like Sayori still hasn't caught onto the kind of situation I'm in.	未だにサヨリは俺がどういう状況に置かれているか理解していないようだ。	It looks like Sayori still hasn't caught onto the kind of situation I'm in.	いまだにサヨリは、俺がどういう状況に置かれているか理解していないようだ。
Sure, being friends with everyone is nice, but...	勿論みんなと親交を深めることは良いのだが……	Sure, being friends with everyone is nice, but...	もちろん、みんなと親交を深めることは良いのだが……
...Does it really need to stop there?	……本当にそこで止めてしまって良いのだろうか？	...Does it really need to stop there?	……誰かともっと深い仲になることもあったりして……。
「We'll just have to see what the future holds, Sayori.」	「この先何が待ち構えているかは見ものだな、サヨリ」	We'll just have to see what the future holds, Sayori.	「この先どうなるか楽しみだな、サヨリ」
I pat Sayori on the shoulder.	俺はサヨリの肩をぽんと叩いた。	I pat Sayori on the shoulder.	俺はサヨリの肩をぽんと叩いた。
I said that more to myself than to her, but it's easy to use Sayori as an internal monologue sometimes.	むしろ自分自身に放った言葉だが、時にサヨリは独りごとの相手として役に立つ。	I said that more to myself than to her, but it's easy to use Sayori as an internal monologue sometimes.	むしろ自分自身に放った言葉だが、時にサヨリは独り言の相手として役に立つ。
「Okay~!」	「そうだね～！」	Okay~!	「そうだね～！」
Yeah...	それじゃあ……	Yeah...	よし……
Let's do this!	がんばるぞ！	Let's do this!	がんばるぞ！
