「You know, I've always hated how hard it is to make friends...」	「私、友達を作るのって本当に難しくて嫌になっちゃうのよね……」	You know, I've always hated how hard it is to make friends...	「友達をつくるのって本当に難しくて、嫌になっちゃうのよね……」
「Well, I guess not the 'making friends' part, but more like meeting new people.」	「いえ、友達作りというよりは新しい人と出会うことね」	Well, I guess not the 'making friends' part, but more like meeting new people.	「いえ、『友達づくり』というよりは新しい人と出会うことね」
「I mean, there are like, dating apps and stuff, right?」	「まあ、出会い系アプリとかがあるかもしれないけどね？」	I mean, there are like, dating apps and stuff, right?	「まあ、出会い系アプリとかがあるかもしれないけど」
「But that's not the kind of thing I'm talking about.」	「でも私が話してるのはそんなのじゃないわ」	But that's not the kind of thing I'm talking about.	「でも私が話してるのはそんなのじゃないわ」
「If you think about it, most of the friends you make are people you just met by chance.」	「考えてみると、友達ってほとんどは偶然に出会った人たちとなるものでしょ」	If you think about it, most of the friends you make are people you just met by chance.	「考えてみると、友達ってほとんどは偶然に出会った人となるものでしょ」
「Like you had a class together, or you met them through another friend...」	「クラスが一緒だったり、共通の友達を通したりして……」	Like you had a class together, or you met them through another friend...	「クラスが一緒だったり、共通の友達を通したりして……」
「Or maybe they were just wearing a shirt with your favorite band on it, and you decided to talk to them.」	「もしくは好きなバンドのTシャツを着てた人に声をかけてみたり」	Or maybe they were just wearing a shirt with your favorite band on it, and you decided to talk to them.	「もしくは好きなバンドのTシャツを着てた人に声をかけてみたり」
「Things like that.」	「そんな感じよね」	Things like that.	「そんな感じよね」
「But isn't that kind of...inefficient?」	「でもそれって……非効率的じゃない？」	But isn't that kind of...inefficient?	「でもそれって……非効率的じゃない？」
「It feels like you're just picking at complete random, and if you get lucky, you make a new friend.」	「適当に人を選んで、運が良ければ友達になれるってだけでしょ」	It feels like you're just picking at complete random, and if you get lucky, you make a new friend.	「適当に人を選んで、運が良ければ友達になれるってだけでしょ」
「And comparing that to the hundreds of strangers we walk by every single day...」	「それを毎日通りすがる何百人もの見知らぬ人々と比べてみて……」	And comparing that to the hundreds of strangers we walk by every single day...	「それを毎日通りすぎる何百人もの見知らぬ人々と比べてみて……」
「You could be sitting right next to someone compatible enough to be your best friend for life.」	「一生の親友になれるほど相性の良い人がすぐ隣に座ってるかもしれない」	You could be sitting right next to someone compatible enough to be your best friend for life.	「一生の親友になれるほど相性の良い人がすぐ隣に座ってるかもしれない」
「But you'll never know.」	「でもそんなこと知る由もない」	But you'll never know.	「でもそんなこと知る由もない」
「Once you get up and go on with your day, that opportunity is gone forever.」	「そして立ち去ったその瞬間に、その機会は一生失われる」	Once you get up and go on with your day, that opportunity is gone forever.	「そして立ち去ったその瞬間に、その機会は一生失われる」
「Isn't that just depressing?」	「憂鬱だと思わない？」	Isn't that just depressing?	「憂鬱だと思わない？」
「We live in an age where technology connects us with the world, no matter where we are.」	「私たちは科学技術によって常にどこでも世界と繋がっている時代に生きてるわ」	We live in an age where technology connects us with the world, no matter where we are.	「私たちは科学技術によって、どこにいても世界とつながっている時代に生きてるわ」
「I really think we should be taking advantage of that to improve our everyday social life.」	「それを有効活用してみんなの社会生活を向上させるべきだと思うの」	I really think we should be taking advantage of that to improve our everyday social life.	「それを有効活用してみんなの社会生活を向上させるべきだと思うの」
「But who knows how long it'll take for something like that to successfully take off...」	「でもそんな仕組みが出来るまであとどれくらいかかるんでしょうね……」	But who knows how long it'll take for something like that to successfully take off...	「でもそんな仕組みができるまで、あとどれくらいかかるんでしょうね……」
「I seriously thought it would happen by now.」	「それくらいとっくに出来てると思ってたのに」	I seriously thought it would happen by now.	「それくらいとっくにできてると思ってたのに」
「Well, at least I already met the best person in the whole world...」	「まあ、私はもう自分にとって最高の相手と出会えたけど……」	Well, at least I already met the best person in the whole world...	「まあ、私はもう自分にとって最高の相手と出会えたけど……」
「Even if it was by chance.」	「これも偶然だったとはいえ」	Even if it was by chance.	「これも偶然だったとはいえ」
「I guess I just got really lucky, huh?」	「私もすごく運が良かったみたいね？」	I guess I just got really lucky, huh?	「私もすごく運が良かったみたいね？」
「Ahaha~」	「あははっ」	Ahaha~	「あはは～」
