「I was thinking about Sayori earlier...」	「さっきサヨリのことを考えてたんだけど……」	I was thinking about Sayori earlier...	「さっきサヨリのことを考えてたんだけど……」
「I still wish I could have handled that whole thing a little more tactfully.」	「あの状況、私ももっとそつなくこなせたら良かったのに」	I still wish I could have handled that whole thing a little more tactfully.	「あの状況、私ももっとそつなくこなせたら良かったのに」
「You're not still hung up over it, right?」	「まだあのことが引っかかってるわけじゃないわよね？」	You're not still hung up over it, right?	「まだあのことが引っかかってるわけじゃないわよね？」
「...Oh my gosh, I can't believe I just said that.」	「……うわっ、私今なんてことを言ったの？」	...Oh my gosh, I can't believe I just said that.	「……ああっ、私、今何てことを言ったの？」
「That pun was completely unintentional, I swear!」	「今のはわざとじゃないから！ 本当に！」	That pun was completely unintentional, I swear!	「今のはわざとじゃないから！ 本当に！」
「But anyway...」	「それは置いといて……」	But anyway...	「それで……」
「I know how much you cared about her, so it only feels right for me to share her last moments with you.」	「あなたがどんなに気に掛けていたのか知ってるから、あの子の最期を教えておこうと思ったの」	I know how much you cared about her, so it only feels right for me to share her last moments with you.	「あなたがどんなに気にかけていたか知ってるから、あの子の最期を教えておこうと思ったの」
「You know how Sayori is really clumsy?」	「サヨリって本当ドジでしょ？」	※削除された文	※削除された文
「Well, she kind of messed up the whole hanging thing...」	「まあ、首吊る時もドジしちゃったんだけど……」	※削除された文	※削除された文
「You're supposed to jump from high enough that the rope snaps your neck, making it quick and painless.」	「本来は縄で頚椎が折れて即死できるように、高いところから跳ぶべきなのよ」	※削除された文	※削除された文
「But she just used a chair, meaning she kind of just left herself to slowly asphyxiate.」	「でもあの子は椅子の高さから跳んだから、じわじわ窒息死することになっちゃったの」	※削除された文	※削除された文
「But a few seconds in, she must have changed her mind or something...」	「でも数秒経ってから、気が変わったのかしら……」	I think a few seconds in, she must have changed her mind or something...	「数秒経ってから、気が変わったのかしら……」
「Because she started clawing at the rope, trying to free herself.」	「自分を解放するために、縄を切ろうと引っ掻き始めたの」	Because she started clawing at the rope, trying to free herself.	「自分を解放するために、縄を切ろうと引っ掻き始めたの」
「She must have kept at it all the way until she lost consciousness.」	「意識がなくなるその瞬間までやってたんでしょうね」	She must have kept at it all the way until she lost consciousness.	「意識がなくなるその瞬間までやってたんでしょうね」
「That's why her fingertips were all bloody, anyway.」	「まあ、指が血まみれだったのはそれが理由なんだけど」	That's why her fingertips were all bloody, anyway.	「まあ、指が血まみれだったのはそれが理由なんだけど」
「Come to think of it, it was probably less 'changing her mind' and more just her survival instincts kicking in.」	「よくよく考えると、あれは気が変わったというより、生存本能によるものだったのかも」	Come to think of it, it was probably less 'changing her mind' and more just her survival instincts kicking in.	「よくよく考えると、あれは『気が変わった』というより、生存本能によるものだったのかも」
「So you can't really fault her for that.」	「そうだとしたら仕方ないことよね」	So you can't really fault her for that.	「そうだとしたら仕方ないことよね」
「It's easier to think that she probably wouldn't have changed her mind anyway, right?」	「気が変わったわけじゃなかったって思った方が、こちらとしても気が楽よね？」	It's easier to think that she probably wouldn't have changed her mind anyway, right?	「気が変わったわけじゃなかったって思った方が、こちらとしても気が楽よね？」
「It's not healthy to think about the things you could have done differently.」	「自分の過去を後悔することはよくないわ」	It's not healthy to think about the things you could have done differently.	「自分の過去を後悔することはよくないわ」
「So just remember that even though you could have saved her, it's technically not your fault she killed herself.」	「助けられたかもしれないけど、あの子が自殺したのは厳密に言うとあなたのせいじゃなかったんだから」	So just remember that even though you could have saved her, it's technically not your fault she killed herself.	「助けられたかもしれないけど、あの子が自殺したのは厳密に言うとあなたのせいじゃなかったんだから」
「I may have exacerbated it a little bit, but Sayori was already mentally ill.」	「私がちょっと悪化させたかもしれないけど、サヨリは元から精神を患っていたんだもの」	I may have exacerbated it a little bit, but Sayori was already mentally ill.	「私がちょっと悪化させたかもしれないけど、サヨリは元から精神を患っていたんだもの」
「Still, though...」	「それにしても……」	Still, though...	「とは言え……」
「I wonder how things would be if you and I just started dating from the get-go?」	「もし私たちが最初から付き合ってれば、どんなに違ったでしょうね？」	I wonder how things would be if you and I just started dating from the get-go?	「もし私たちが最初から付き合ってれば、どんなに違ったでしょうね？」
「I guess we'd all still be in the clubroom, writing poems and having fun together.」	「きっと今頃も、部室でみんなで詩を書きながら楽しくやってたんでしょうね」	I guess we'd all still be in the clubroom, writing poems and having fun together.	「きっと今頃も、部室でみんなで詩を書きながら楽しくやってたんでしょうね」
「But what's the point when none of it is even real?」	「でも全て偽りなのに、それに何の意味があると言うの？」	But what's the point when none of it is even real?	「でもすべて偽りなのに、それに何の意味があると言うの？」
「I mean, it's the same ending either way, right?」	「それに、どう転んでも同じエンディングだったんだし？」	I mean, it's the same ending either way, right?	「それに、どう転んでも同じエンディングだったんだし？」
「The two of us, happily together...」	「二人一緒で、幸せで……」	The two of us, happily together...	「私たちは二人一緒で、幸せで……」
「There's no reason to ask for any more than that.」	「それ以上は何もいらないわ」	There's no reason to ask for any more than that.	「それ以上は何もいらないわ」
「I was just pointlessly musing - I'm really as happy as I could be right now.」	「特に意味もなく物思いにふけてただけよ。今が今まで一番幸せなんだもの」	I was just pointlessly musing - I'm really as happy as I could be right now.	「特に意味もなく物思いに耽ってただけよ。今が今までで一番幸せなんだもの」
