It's an ordinary school day, like any other.	いつもと変わらない学校の日。	It's an ordinary school day, like any other.	いつもと変わらない学校の日。
As usual, I'm surrounded by couples and friend groups walking to school together.	いつも通り、俺はカップルや友達グループに囲まれながら学校へ向かう。	As usual, I'm surrounded by couples and friend groups walking to school together.	俺はいつも通り、カップルや友達グループに囲まれながら学校へ向かう。
I always tell myself it's about time I meet some girls or something like that...	俺もそろそろ女の子と仲良くなったりするべきなのかもしれないが……	I always tell myself it's about time I meet some girls or something like that...	俺もそろそろ女の子と仲良くなったりするべきなのかもしれないが……
「Hey, [player]...」	「ねえ、[player]……」	Hey, [player]...	「ねえ、[player]君」
...Well, there already is one girl.	……まあ、女の子なら身近に一人いる。	...Well, there already is one girl.	……まあ、女の子なら身近に一人いる。
That girl is Sayori, my neighbor and good friend since we were children.	あの子はサヨリといって、近所に住んでいる幼馴染だ。	That girl is Sayori, my neighbor and good friend since we were children.	あの子はサヨリといって、近所に住んでいる幼馴染だ。
We used to walk to school together every day...	昔はよく一緒に登校していたが……	We used to walk to school together every day...	昔は毎日一緒に登校していて……
...And recently, we've picked up that habit once again.	……最近になって、それをまた再開した。	...And recently, we've picked up that habit once again.	……最近になって、また一緒に登校し始めた。
「[player], are you proud of me?」	「[player]、わたしのこと偉いって思う？」	[player], are you proud of me?	「[player]、わたしのこと偉いって思う？」
「Eh? For what?」	「は？ なんで？」	Eh? For what?	「は？ 何で？」
「You know...」	「だって……」	You know...	「そう……」
「For waking up on time!」	「ちゃんと時間通りに起きれたんだもん！」	For waking up on time!	「ちゃんと時間通りに起きれたんだもん！」
「Well, you've been doing that for a while now...」	「まあ、最近はちゃんと起きれてるよな……」	Well, you've been doing that for a while now...	「まあ、最近はちゃんと起きれてるよな……」
「Uh-huh!」	「でしょでしょ！」	Uh-huh!	「でしょでしょ！」
「But you never even said anything about it!」	「なのに何も言ってくれないじゃん！」	But you never even said anything about it!	「なのに何も言ってくれないじゃん！」
「Even though we walk to school together every day...」	「毎日一緒に登校してるのに……」	Even though we walk to school together every day...	「毎日一緒に登校してるのに……」
「Well, yeah...」	「まあ、それは……」	Well, yeah...	「いや、まあ……」
「I always thought it was implied.」	「言わなくても分かるかと思って」	I always thought it was implied.	「言わなくてもわかるかと思って」
「It's embarrassing to say out loud.」	「そういうこと言うのも恥ずかしいし」	It's embarrassing to say out loud.	「そういうこと言うのも恥ずかしいし」
「C'mon, please?」	「そんなぁ……お願い！」	C'mon, please?	「どうしても、来てくれないの？」
「It's good motivation~」	「良いモチベーションになるから～」	It's good motivation~	「良いモチベーションになるから～」
「Fine, fine...」	「分かった、分かった……」	Fine, fine...	「はいはい……」
「I'm proud of you, Sayori.」	「偉いぞ、サヨリ」	I'm proud of you, Sayori.	「偉いぞ、サヨリ」
「Ehehe~」	「えへへ～」	Ehehe~	「うふふ」
We cross the street together and make our way to school.	俺たちは道路を渡り、学校へ歩みを進める。	We cross the street together and make our way to school.	俺たちは横断歩道を渡り、学校へと歩みを進める。
As we draw near, the streets become increasingly speckled with other students making their daily commute.	学校に近づくと、通学路には他の生徒の姿が徐々に増えていく。	As we draw near, the streets become increasingly speckled with other students making their daily commute.	学校に近づくにつれ、通学路には他の生徒の姿が徐々に増えていく。
「By the way, [player]...」	「ところでさ、[player]……」	By the way, [player]...	「ところでさ、[player]……」
「Have you decided on a club to join yet?」	「まだ入る部活は決めてないの？」	Have you decided on a club to join yet?	「入る部活って、まだ決めてないの？」
「A club?」	「部活？」	A club?	「部活？」
「I told you already, I'm really not--」	「部活は興味ないって前から――」	I told you already, I'm really not--	「前に言っただろ、マジで部活には――」
I start to say what I always do - that I'm not interested in joining any clubs.	いつもと同じ台詞を言うところだった――部活には興味ない、と。	I start to say what I always do - that I'm not interested in joining any clubs.	いつもと同じ台詞を言うところだった――部活には興味ない、と。
But something tells me Sayori would take more offense to that now.	だが今それを言うと、彼女を傷つける気がして言えなかった。	But something tells me Sayori would take more offense to that now.	だが今それを言うと、彼女を傷つける気がして言えなかった。
After all, how could I tell her that clubs are a waste of time...	自分で部活を立ち上げたばかりの人を目の前にして……	After all, how could I tell her that clubs are a waste of time...	自分で部活を立ち上げたばかりの人に向かって……
...when she's starting a club of her very own?	……部活は時間の無駄だ、なんて言えるわけない。	...when she's starting a club of her very own?	……部活は時間の無駄だ、なんて言えるわけない。
「...Actually, yeah.」	「……いや、そうだな」	...Actually, yeah.	「……いや、そうだな」
「I think I've decided on a club.」	「部活はもうほぼ決めた」	I think I've decided on a club.	「部活はもうほぼ決めた」
「Really?!」	「ほんと！？」	Really?!	「そうなの！？」
「Which one? Tell me!」	「どこどこ？ 教えて！」	Which one? Tell me!	「どこどこ？ 教えて！」
「Hmm...」	「うーん……」	Hmm...	「ふーん……」
「I think I'll keep it a surprise.」	「それは見てからのお楽しみにってことで」	I think I'll keep it a surprise.	「それは決めてからのお楽しみにってことで」
「Boo...」	「ええぇ～……」	Boo...	「ええぇ～……」
「You meanie.」	「いじわる……」	You meanie.	「いじわる……」
「Be patient, you'll find out soon enough.」	「そのうち分かることだよ」	Be patient, you'll find out soon enough.	「そのうちわかることだよ」
I used to ask myself why I let myself get lectured by such a carefree girl.	どうして俺はこんな呑気な奴に説教されることを許してるのか考えたこともあったが……	I used to ask myself why I let myself get lectured by such a carefree girl.	どうして俺は、こんなノンキなやつに説教されるのを許しているのかと考えたこともあったが……
But I started to realize that in a way, I envy her.	俺はきっと彼女をある意味羨んでいるのだろう。	But I started to realize that in a way, I envy her.	俺はきっと、彼女をある意味羨んでいるのだ。
When Sayori puts her mind to something, she can accomplish great things.	サヨリは一つの物事に集中すると、すごいことを成し遂げられる力がある。	When Sayori puts her mind to something, she can accomplish great things.	サヨリは物事に集中すると、結果を出すことができる。
So that's why I feel like I should do something special for her.	だから俺も彼女に何か特別なことをしたくなるのだろう。	So that's why I feel like I should do something special for her.	だから俺もあいつのお節介を許しているのだろうし、何かしてあげたくなるのだ。
The school day is as ordinary as ever, and it's over before I know it.	普段通りの学校生活は、いつの間にか終わっていた。	The school day is as ordinary as ever, and it's over before I know it.	普段通りの授業が、気づかぬうちに終わっていく。
After I pack up my things, I stand up, gathering my motivation.	荷物をまとめて立ち上がり、自分の中のやる気をかき集める。	After I pack up my things, I stand up, gathering my motivation.	帰り支度を終え、自分のやる気をかき集める。
「Let's see...」	「さてと……」	Let's see...	「そうですね……」
I recall the room number of the club from a flier I saw.	勧誘のビラの記憶を頼りに、部室の番号を思い出す。	I recall the room number of the club from a flier I saw.	勧誘のビラの記憶を頼りに、部室の番号を思い出す。
I walk across the school and upstairs - a section of the school I rarely visit, being generally used for third-year classes and activities.	俺は校舎をわたり階段を上っていく。着いたのは、学校の中でも普段は３年生の授業や活動で使用され、自分は滅多に行くことがない場所だった。	I walk across the school and upstairs - a section of the school I rarely visit.	俺は校舎をわたり、階段を上がっていく。――着いたのは、学校の中でも滅多に足を踏み入れない場所だった。
Before long, I find the room.	間もなく俺は目的の部屋を発見した。	Before long, I find the room.	間もなく俺は、目的の部屋を発見した。
I timidly open the door in front of me.	目の前の扉をゆっくり開いた。	I timidly open the door in front of me.	目の前のドアをおずおずと開く。
「Hello...?」	「失礼します……」	Hello...?	「失礼します……」
「Ah!」	「あっ！」	Ah!	「あっ！」
「[player]...?!」	「[player]……！？」	[player]...?!	「[player]……！？」
「W-What are you doing here?」	「な、なんでここにいるの？」	W-What are you doing here?	「な、何でここに？」
「Well...I just--」	「まあ、それは――」	Well...I just--	「まあ、それは――」
Eh? I glance around the room.	えっ？ 教室をひと目見回した。	Eh? I glance around the room.	俺は、教室をひと目見回した。
「Huh.」	「ふーん」	Huh.	「ふーん」
「So you're the [player] that Sayori's always talking about?」	「あんたがサヨリのよく話してる[player]ってやつ？」	So you're the [player] that Sayori's always talking about?	「アンタがサヨリのよく話してる[player]ってヤツ？」
「T-Thank you for stopping by!」	「き、来てくださってありがとうございます！」	T-Thank you for stopping by!	「き、来てくださってありがとうございます！」
「It's a pleasure to meet you, [player].」	「お会いできて嬉しいです、[player]さん」	It's a pleasure to meet you, [player].	「お会いできてうれしいです、[player]さん」
「We're the Literature Club.」	「こちらは文芸部です」	We're the Literature Club.	「ここは文芸部です」
「I-I hope you enjoy your visit!」	「た、楽しんでいって頂けると幸いです！」	I-I hope you enjoy your visit!	「た、楽しんでいっていただけると幸いです！」
「C'mon, Yuri...」	「もう、ユリ……」	C'mon, Yuri...	「もう、ユリ……」
「No need to be so formal.」	「そんなにかしこまらなくてもいいでしょ」	No need to be so formal.	「そんなにかしこまらなくてもいいでしょ」
「He's gonna think we're really strict or something...」	「すごく堅苦しい部活みたいに思われるじゃない……」	He's gonna think we're really strict or something...	「すごく堅苦しい部活みたいに思われるじゃない……」
「Ah...」	「あっ……」	Ah...	「あのね……」
「Sorry, Natsuki...」	「ごめんなさい、ナツキちゃん……」	Sorry, Natsuki...	「ごめんなさい、ナツキちゃん……」
The tall one, whose name is apparently Yuri, seems to be quite shy compared to the others.	一番身長の高いユリと呼ばれる子は、他よりも控えめのようだ。	The tall one, whose name is apparently Yuri, seems to be quite shy compared to the others.	一番身長の高いユリと呼ばれる子は、かなり控えめな性格のようだ。
In comparison, the girl named Natsuki - despite her size - seems like the assertive one.	対してナツキと呼ばれる子は身長の小ささに関わらず、一番我が強いタイプのようだ。	In comparison, the girl named Natsuki - despite her size - seems like the assertive one.	対してナツキと呼ばれる子は体は小さいが、一番自己主張が強いタイプのようだ。
「Well, it's nice to meet both of you.」	「二人とも会えて嬉しいよ」	Well, it's nice to meet both of you.	「二人とも、会えてうれしいよ」
「I look forward to working with you.」	「これからよろしくな」	I look forward to working with you.	「これからよろしくな」
「W-Working...?」	「こ、これから……？」	W-Working...?	「こ、これから……？」
「[player], don't tell me...」	「[player]、もしかして……」	[player], don't tell me...	「[player]……」
「You're...」	「部活ってまさか……」	You're...	「もしかして……」
「That's right.」	「そうだ」	That's right.	「ああ」
「The club I've decided to join is yours, Sayori.」	「俺が入部を決めたのはお前の部活だ、サヨリ」	The club I've decided to join is yours, Sayori.	「俺が入部を決めたのはお前の部活だ、サヨリ」
「The Literature Club.」	「文芸部だよ」	The Literature Club.	「文芸部だよ」
Sayori's eyes light up.	サヨリの目が光る。	Sayori's eyes light up.	サヨリが目を輝かせる。
「...No way.」	「……うそ」	...No way.	「……うそ」
「No way!」	「うそおおぉ！！」	No way!	「うそおおぉ！！」
「Aaaahhhhhh!」	「やったあああぁぁぁっ！！！」	Aaaahhhhhh!	「やったあああぁぁぁっ！！！」
Sayori wraps her arms around me, jumping up and down.	サヨリは俺に腕を回し、ぴょんぴょん飛び跳ねる。	Sayori wraps her arms around me, jumping up and down.	サヨリは俺に腕を回し、ぴょんぴょん飛び跳ねる。
「H-Hey--」	「お、おい――」	H-Hey--	「お、おい――」
「Ehehe.」	「えへへ」	Ehehe.	「えへへ」
「Well, if Sayori is this happy, then I'm sure it won't be so bad to have you around.」	「サヨリがこんなに喜ぶほどなら、あんたが入るのもそんな悪いことじゃないかもね」	Well, if Sayori is this happy, then I'm sure it won't be so bad to have you around.	「サヨリがこんなに喜ぶほどなら、アンタが入るのもそんな悪いことじゃないかもね」
「Not to mention there's four of us now.」	「それに部員もこれで４人です」	Not to mention there's four of us now.	「それに部員もこれで４人です」
「That means we can become an officially-recognized club.」	「正式に部活として申請することができますね」	That means we can become an officially-recognized club.	「正式に部活として申請することができますね」
「I don't know what to say!」	「もうなんて言えばいいんだろ！」	I don't know what to say!	「もうなんて言えばいいんだろ！」
「We have to celebrate!」	「とにかくお祝いしなきゃ！」	We have to celebrate!	「とにかくお祝いしなきゃ！」
「Huhu.」	「ふふっ」	Huhu.	「ふふっ」
「What an appropriate day for that, isn't it?」	「それには今日は絶好の日ですよね？」	What an appropriate day for that, isn't it?	「それには今日は絶好の日ですよね？」
「Yeah!」	「うん！」	Yeah!	「いいね！」
「After all, Natsuki decided to--」	「なんて言ったってナツキちゃんが――」	After all, Natsuki decided to--	「なんて言ったってナツキちゃんが――」
「Hey, don't ruin the surprise!」	「ちょっと！ まだ言うんじゃないわよ！」	Hey, don't ruin the surprise!	「ちょっと！ まだ言うんじゃないわよ！」
「Ehehe, sorry...」	「えへへ、ごめん……」	Ehehe, sorry...	「えへへ、ごめん……」
「Everyone sit down at the table, okay?」	「みんなはあそこのテーブルに座ってなさい」	Everyone sit down at the table, okay?	「みんなはあそこのテーブルに座ってなさい」
「How about I make some tea as well?」	「それでは、私はお茶を淹れますね」	How about I make some tea as well?	「それでは、私はお茶を淹れますね」
The girls have a few desks arranged to form a table.	机が並べられて作られたテーブルがある。	The girls have a few desks arranged to form a table.	机を並べてつくったテーブルがある。
Natsuki and Yuri walk over to the corner of the room, where Natsuki grabs a wrapped tray and Yuri opens the closet.	ナツキとユリは教室の隅に向かった。ナツキはホイルで包まれたトレイを取り、ユリはクローゼットを開けている。	Natsuki and Yuri walk over to the corner of the room, where Natsuki grabs a wrapped tray and Yuri opens the closet.	ナツキとユリは教室の隅に向かった。ナツキはホイルで包まれたトレイを取り、ユリは物置を開けている。
Still feeling awkward, I take a seat next to Sayori.	未だに気まずさを感じつつも、俺はサヨリの隣の席に座る。	Still feeling awkward, I take a seat next to Sayori.	居心地の悪さを感じつつも、俺はサヨリの隣の席に座る。
Natsuki proudly marches back to the table, tray in hand.	ナツキはトレイを持って、誇らしげにテーブルへやって来た。	Natsuki proudly marches back to the table, tray in hand.	トレイを持ったナツキが、誇らしげにテーブルへやって来た。
「Okaaay, are you ready?」	「準備はいいかしら？」	Okaaay, are you ready?	「準備はいいかしら？」
「...Ta-daa!」	「じゃじゃーん！」	...Ta-daa!	「じゃじゃーん！」
「Uwooooah!」	「うっわああぁぁ～～っ！！」	Uwooooah!	「うっわああぁぁ～～っ！！」
Natsuki lifts the foil off the tray to reveal a dozen white, fluffy cupcakes decorated to look like little cats.	ナツキがアルミホイルをめくると白くてかわいい、子猫のようなカップケーキが12個顔を見せた。	Natsuki lifts the foil off the tray to reveal a dozen white, fluffy cupcakes decorated to look like little cats.	ナツキがアルミホイルをめくると、白くてかわいい子猫のような12個のカップケーキが顔を見せた。
The whiskers are drawn with icing, and little pieces of chocolate were used to make ears.	猫のひげはアイシングで、耳は少量のチョコで作られているようだ。	The whiskers are drawn with icing, and little pieces of chocolate were used to make ears.	猫のひげはアイシングで、耳は少量のチョコでつくられているようだ。
「So cuuuute~!」	「すっごくかわいいぃ～！」	So cuuuute~!	「すっごくかわいいぃ～！」
「Wow, those look amazing.」	「すごいな、これ！」	Wow, those look amazing.	「すごいな、これ！」
「Ehehe. Well, you know.」	「えへへ。まあ、ね」	Ehehe. Well, you know.	「えへへ。まあ、ね」
「Just hurry and take one!」	「早く食べてよね！」	Just hurry and take one!	「早く食べてよね！」
Sayori grabs one first, then I follow.	サヨリが一つ手に取り、俺も続いた。	Sayori grabs one first, then I follow.	サヨリが一つ手に取り、俺も続いた。
「It's delicious!」	「おいしい！」	It's delicious!	「おいしい！」
Sayori talks with her mouth full and has already managed to get icing on her face.	サヨリはカップケーキで口をいっぱいにして話し、顔にアイシングがついてしまっている。	Sayori talks with her mouth full and has already managed to get icing on her face.	サヨリはカップケーキを頬張って言い、顔にはアイシングがついてしまっている。
I turn the cupcake around in my fingers, looking for the best angle to take a bite.	俺は食べやすい向きを探してカップケーキを回す。	I turn the cupcake around in my fingers, looking for the best angle to take a bite.	俺は食べやすい向きを探してカップケーキを回す。
Natsuki is quiet.	ナツキは黙りこくっている。	Natsuki is quiet.	ナツキは黙りこくっている。
I can't help but notice her sneaking glances in my direction.	俺に対する彼女の無言の視線を気にせずにはいられない。	I can't help but notice her sneaking glances in my direction.	俺に対する彼女の無言の視線を気にせずにはいられない。
Is she waiting for me to take a bite?	俺が食べるのを待っているのか？	Is she waiting for me to take a bite?	俺が食べるのを待っているのか？
I finally bite down.	ついにカップケーキを口に運ぶ。	I finally bite down.	ついにカップケーキを口に運ぶ。
The icing is sweet and full of flavor - I wonder if she made it herself.	アイシングは甘く風味豊かで――これ、本当にナツキが作ったのか？	The icing is sweet and full of flavor - I wonder if she made it herself.	アイシングは甘く風味豊かで――これ、本当にナツキがつくったのか？
「This is really good.」	「これ、すごく美味いぞ」	This is really good.	「これ、すごく美味い」
「Thank you, Natsuki.」	「ありがとう、ナツキ」	Thank you, Natsuki.	「ありがとう、ナツキ」
「W-Well...of course it is!」	「あ、当たり前でしょ！」	W-Well...of course it is!	「あ、当たり前でしょ！」
「I'm a pro, after all!」	「わたしはプロなんだから！」	I'm a pro, after all!	「わたしはプロなんだから！」
「There's no need to thank me or anything...」	「感謝なんか別にしなくったって……」	There's no need to thank me or anything...	「感謝なんか別にしなくったって……」
As Natsuki struggles to accept the compliment, Yuri returns to the table, carrying a tea set.	ナツキが褒められたことを受け入れられずにいると、ユリはティーセットを抱えテーブルに戻ってくる。	As Natsuki struggles to accept the compliment, Yuri returns to the table, carrying a tea set.	褒め言葉を素直に受け取らないナツキの横で、ティーセットを携えたユリが戻ってきた。
She carefully places a teacup in front of each of us before setting down the teapot next to the cupcake tray.	彼女は慎重にみんなの前にティーカップを置き、カップケーキのあるトレイの隣にティーポットを置いた。	She carefully places a teacup in front of each of us before setting down the teapot next to the cupcake tray.	彼女は慎重にみんなの前にティーカップを置き、カップケーキのあるトレイの隣にティーポットを置いた。
「You keep a whole tea set in this classroom?」	「教室にティーセットを置いてるのか？」	You keep a whole tea set in this classroom?	「教室にティーセットを置いてるのか？」
「Don't worry, the teachers gave us permission.」	「大丈夫です、ちゃんと先生方の許可はいただいてますから」	Don't worry, the teachers gave us permission.	「大丈夫です、ちゃんと先生方の許可はいただいてますから」
「After all, doesn't a hot cup of tea help you enjoy a good book?」	「それに、温かいお茶があると読書も捗るでしょう？」	After all, doesn't a hot cup of tea help you enjoy a good book?	「それに、温かいお茶があると読書も捗るでしょう？」
「Ah... I-I guess...」	「ああ……そ、そうだな……」	Ah... I-I guess...	「ああ……そ、そうだな……」
「Ehehe. Already trying to impress our new member, Yuri?」	「ふふ、ユリったらもう新入部員と仲良くなろうとしちゃって～」	Ehehe. Already trying to impress our new member, Yuri?	「ふふ、ユリったらもう新入部員と仲良くなろうとしちゃって～」
「Eh?! T-That's not...」	「え、そ、そんなこと……」	Eh?! T-That's not...	「え、そ、そんなこと……」
Insulted, Yuri looks away.	からかわれて、ユリはそっぽを向く。	Insulted, Yuri looks away.	からかわれて、ユリはそっぽを向く。
「I meant that, you know...」	「私はただ、その……」	I meant that, you know...	「私はただ、その……」
「I believe you.」	「分かってるよ」	I believe you.	「わかってるよ」
「Well, tea and reading might not be a pastime for me, but I at least enjoy tea.」	「まあ、お茶を飲みながらの読書は馴染みのない習慣だが、お茶は普通に好きだから」	Well, tea and reading might not be a pastime for me, but I at least enjoy tea.	「まあ、お茶を飲みながら本なんて読まないけどさ、お茶は普通に好きだから」
「I'm glad...」	「良かった……」	I'm glad...	「うれしいです……」
Yuri faintly smiles to herself in relief.	ユリはほっとしたようにかすかに微笑んでいる。	Yuri faintly smiles to herself in relief.	ユリはほっとしたように小さく微笑んだ。
「So, [player], what kinds of things do you like to read?」	「あの、[player]さんは普段どんな本を読まれるんですか？」	So, [player], what kinds of things do you like to read?	「あの、[player]さんは普段どんな本を読まれるんですか？」
「Well... Ah...」	「ええ、ああ……」	Well... Ah...	「ええ、ああ……」
Considering how little I've read these past few years, I don't really have a good way of answering that.	ここ数年ほとんど本を読んでいないので、なんと答えれば良いのか思いつかない。	Considering how little I've read these past few years, I don't really have a good way of answering that.	ここ数年まともに本を読んでいないので、何て答えればいいのかさえ思いつかない。
「...Manga...」	「……マンガ……とか」	...Manga...	「……マンガ……とか」
I mutter quietly to myself, half-joking.	冗談交じりに呟く。	I mutter quietly to myself, half-joking.	冗談交じりに呟く。
Natsuki's head suddenly perks up.	ナツキの頭がピクンと反応した。	Natsuki's head suddenly perks up.	ナツキがピクンと反応した。
It looks like she wants to say something, but she keeps quiet.	何か言いたげだが、黙っている。	It looks like she wants to say something, but she keeps quiet.	何か言いたげだが、黙っている。
「N-Not much of a reader, I guess...」	「あ、あまり読書家ではないのですね……」	N-Not much of a reader, I guess...	「あ、あまり読書家ではないのですね……」
「...Well, that can change...」	「……今後の変化の余地はある……」	...Well, that can change...	「……まあ、変化の余地はあるし……」
What am I saying?	俺は何を言っているんだろう。	What am I saying?	俺は何を言っているんだろう。
I spoke without thinking after seeing Yuri's sad smile.	ユリが悲しそうに笑ってたから考えなしに言ってしまった。	I spoke without thinking after seeing Yuri's sad smile.	ユリが悲しそうに笑っていたから考えなしに言ってしまった。
「Anyway, what about you, Yuri?」	「それより、ユリはどんな本を読むんだ？」	Anyway, what about you, Yuri?	「それよりさ、ユリはどんな本を読むんだ？」
「Well, let's see...」	「ええとですね……」	Well, let's see...	「そうですね……」
Yuri traces the rim of her teacup with her finger.	ユリは指先でティーカップのふちをなぞる。	Yuri traces the rim of her teacup with her finger.	ユリは指先でティーカップのふちをなぞる。
「My favorites are usually novels that build deep and complex fantasy worlds.」	「私は重厚で複雑な世界観を持ったファンタジーが好きなんです」	My favorites are usually novels that build deep and complex fantasy worlds.	「私は重厚で複雑な世界観を持ったファンタジーが好きなんです」
「The level of creativity and craftsmanship behind them is amazing to me.」	「その世界観を支える創造性や職人芸の凄さといったら、目を見張るものがあるんですよ」	The level of creativity and craftsmanship behind them is amazing to me.	「その世界観を支える創造性や職人芸のすごさといったら、目を見張るものがあるんですよ」
「And telling a good story in such a foreign world is equally impressive.」	「そのような異世界で語られる素敵なストーリーもまた、とても感動的なんです」	And telling a good story in such a foreign world is equally impressive.	「そのような異世界で語られるストーリーもまた、とても感動的なんです」
Yuri goes on, clearly passionate about her reading.	ユリは読書について、とても情熱的に語り続けた。	Yuri goes on, clearly passionate about her reading.	ユリは読書について、とても情熱的に語り続けた。
She seemed so reserved and timid since the moment I walked in, but it's obvious by the way her eyes light up that she finds her comfort in the world of books, not people.	俺が入室した瞬間から控えめでおどおどした様子だった彼女の目が急にぱっと明るくなったことから察するに、彼女は人より本の世界に安らぎを見出すのだろう。	She seemed so reserved and timid since the moment I walked in, but it's obvious by the way her eyes light up that she finds her comfort in the world of books, not people.	俺が入室した瞬間から控えめでおどおどした様子だった彼女の目が、急にぱっと明るくなった。彼女は、人より本の世界に安らぎを見出すらしい。
「But you know, I like a lot of things.」	「でもね、他にも様々なものが好きですよ」	But you know, I like a lot of things.	「でも、他にも好きなものはたくさんありますよ」
「Don't feel intimidated if you don't read much, okay?」	「普段読書をされないからと、引け目に感じることはありませんからね」	Don't feel intimidated if you don't read much, okay?	「普段読書をされないからといって、引け目に感じることはありませんからね」
「I'm certain we can find something that we have in common.」	「みんなの共通点も、きっとじきに見つかります」	I'm certain we can find something that we have in common.	「共通の話題がきっと見つかります」
「Hey, Yuri...」	「ねえ、ユリ……」	Hey, Yuri...	「ねえ、ユリ……」
「Eh?」	「えっ？」	Eh?	「えっ？」
「Well, about...you know, the first thing he said...」	「なんというか、その……そいつが最初に言ってたこと……」	Well, about...you know, the first thing he said...	「何て言うか、その……そいつがさっき言った……」
「Manga?」	「マンガか？」	Manga?	「マンガか？」
「That's right...」	「そう言えば……」	That's right...	「そうですね……」
「Natsuki tends to read manga in the clubroom--」	「ナツキちゃんは部室でマンガを読んでいることが――」	Natsuki tends to read manga in the clubroom--	「ナツキちゃんは部室でマンガを読んでいることが――」
「D-Don't just say it!!」	「い、言わないでよそれ！！」	D-Don't just say it!!	「い、言わないでよ、それ！！」
For some reason, Natsuki seems embarrassed about it.	何故だかナツキは動揺した様子だ。	For some reason, Natsuki seems embarrassed about it.	何故だかナツキは動揺した様子だ。
「Besides...」	「それに……」	Besides...	「それに……」
「Manga...is literature too, you know?」	「マンガも……文学なのよ？」	Manga...is literature too, you know?	「マンガも……文学なのよ？」
「So...if [player] wants to read some of my manga, then don't try to stop him or anything!」	「だから……もし[player]がわたしのマンガを読みたいって言ったら止めたりするんじゃないわよ！」	So...if [player] wants to read some of my manga, then don't try to stop him or anything!	「だから……もし[player]がアタシのマンガを読みたいって言っても、止めたりするんじゃないわよ！」
「Natsuki...」	「ナツキちゃん……」	Natsuki...	「ナツキ……」
「I wouldn't do such a thing.」	「そんなことはしませんよ」	I wouldn't do such a thing.	「そんなことはしませんよ」
「However, it could also be nice for us to diversify ourselves a little...」	「ただ、少し視野を広げるのも良いかと思いまして……」	However, it could also be nice for us to diversify ourselves a little...	「ただ、少し視野を広げるのも良いかと思いまして……」
「He can take this opportunity to try something new, as well.」	「いつもと違うことに挑戦する良い機会でもありますし」	He can take this opportunity to try something new, as well.	「いつもと違うことに挑戦する良い機会でもありますし」
「Wouldn't you agree, [player]?」	「そう思いませんか、[player]さん？」	Wouldn't you agree, [player]?	「そう思いませんか、[player]さん？」
「M-Maybe--」	「そ、それなら……」	M-Maybe--	「そ、それなら……」
Sensing the tension, Sayori jumps in.	空気を読むかのように、サヨリが会話に飛び込んできた。	Sensing the tension, Sayori jumps in.	緊張感を察して、サヨリが会話に飛び込んできた。
「Maybe we can all try something new!」	「それならみんなで違うことに挑戦しようよ！」	Maybe we can all try something new!	「それならみんなで違うことに挑戦しようよ！」
「I think it could be fun...」	「そしたらきっと楽しいし……」	I think it could be fun...	「そしたらきっと楽しいし……」
「And we'll all get to know each other a little bit better, too!」	「お互いのことをもっとよく知れるし！」	And we'll all get to know each other a little bit better, too!	「お互いのことをもっとよく知れるし！」
「I mean...」	「だって……」	I mean...	「ここが……」
「That's the kind of thing literature clubs do...right?」	「文芸部って……そういう部活でしょ？」	That's the kind of thing literature clubs do...right?	「文芸部って……そういう部活でしょ？」
「...」	「……」	...	「……」
「I-I don't disagree or anything...」	「い、異議はありませんが……」	I-I don't disagree or anything...	「い、異議はありませんが……」
「Yeah...」	「わたしも……」	Yeah...	よし……
「You're right as usual, President.」	「さすがは部長って感じね」	You're right as usual, President.	「さすがは部長って感じね」
「Ehehe~」	「えへへ～」	Ehehe~	「うふふ」
「Guess that means I should try picking up a novel or something, huh...?」	「ということは、何か小説を読み始めた方がいいみたいね……？」	Guess that means I should try picking up a novel or something, huh...?	「ということは、何か小説を読み始めた方がいいみたいね……？」
「Well, that would make two of us...」	「これで二人だな……」	Well, that would make two of us...	「これで二人だな……」
「I wouldn't mind doing it if I'm not the only one.」	「二人いるならやってやらないでもないが」	I wouldn't mind doing it if I'm not the only one.	「二人いるならやってやらないでもないが」
「Then as for Yuri...」	「それでユリは……」	Then as for Yuri...	「それでユリは……」
「Eh...?」	「えっ……？」	Eh...?	「え……？」
「I...I have to read manga...?」	「マ……マンガを読まねばならないのですか？」	I...I have to read manga...?	「マ……マンガを読まねばならないのですか？」
「Jeez...」	「もう……」	Jeez...	「はあ……」
「You were the one who suggested we diversify!」	「視野を広げろって言い出したのはあんたでしょ！」	You were the one who suggested we diversify!	「視野を広げろって言い出したのはアンタでしょ！」
「You should be a little more open-minded...」	「もうちょっと頭を柔らかくできないの？」	You should be a little more open-minded...	「もうちょっと頭を柔らかくできないの？」
「It's kind of hurtful...」	「なんだか傷つく……」	It's kind of hurtful...	「何か傷つく……」
「Hurtful...?」	「傷つく……？」	Hurtful...?	「傷つく……？」
「I-I didn't realize...」	「そ、そんなつもりは……」	I-I didn't realize...	「そ、そんなつもりは……」
「...」	「……」	...	「……」
With a guilty expression, Yuri thinks to herself.	申し訳なさそうに、ユリはしばらく考え込んだ。	With a guilty expression, Yuri thinks to herself.	申しわけなさそうに、ユリはしばらく考え込んだ。
「I'm sorry for disrespecting your interests, Natsuki.」	「ナツキちゃん、あなたの趣味を否定するような事を言ってごめんなさい」	I'm sorry for disrespecting your interests, Natsuki.	「ナツキちゃん、あなたの趣味を否定するようなことを言ってごめんなさい」
「If...if you're into it, then I'm sure it's a worthy form of literature.」	「あなたが……あなたがそんなに好きなものなら、それもきっと立派な文学なのだと思います」	If...if you're into it, then I'm sure it's a worthy form of literature.	「あなたが……あなたがそんなに好きなものなら、それもきっと立派な文学なのだと思います」
「...Are you just saying that?」	「……それって言ってるだけ？」	...Are you just saying that?	「……って口先だけでしょ？」
「No...」	「いいえ……」	No...	「いいえ……」
「I've realized my error.」	「自分の過ちに気づきました」	I've realized my error.	「自分の過ちに気づきました」
「So, if you're willing to consider starting a novel...」	「だから、あなたが小説を読み始めるというのなら……」	So, if you're willing to consider starting a novel...	「だから、あなたが小説を読み始めるというのなら……」
「...Then I'll offer my gratitude by finding a manga to read as well.」	「……私もマンガを読んでみることでそのお気持ちをお返しします」	...Then I'll offer my gratitude by finding a manga to read as well.	「……私もマンガを読んでみることでそのお気持ちをお返しします」
「Really?!」	「ほんと！？」	Really?!	「ホント！？」
「I-I mean...」	「そ、その……」	I-I mean...	「い、いや、その……」
「It...makes me happy that you'd do that for me, Yuri.」	「ユリがわたしを思ってそうしてくれるなら……嬉しい」	It...makes me happy that you'd do that for me, Yuri.	「ユリがアタシを思ってそうしてくれるなら……うれしい」
「You can trust me to find something that you'll really like, okay?」	「わたし、あんたが好きそうな作品を絶対見つけてくるからね」	You can trust me to find something that you'll really like, okay?	「アタシ、アンタが好きそうな作品を絶対見つけてくるからね」
「Same here...」	「こちらこそ……」	Same here...	「私もそうします……」
「Perhaps I'll visit the bookstore after the club meeting.」	「部活が終わったら本屋に寄って帰ろうかと思います」	Perhaps I'll visit the bookstore after the club meeting.	「部活が終わったら本屋に寄って帰ろうかと思います」
「Just...just you?」	「えっ……一人で？」	Just...just you?	「えっ……一人で？」
「A-Ah--」	「あ、あのっ……」	A-Ah--	「あ、あっ……」
「Would you...like to come along with me?」	「よかったら……一緒に行きませんか？」	Would you...like to come along with me?	「よかったら……一緒に行きませんか？」
「Um...」	「えっと……」	Um...	「その……」
「If you don't mind...」	「ユリが構わないなら……」	If you don't mind...	「ユリが構わないなら……」
「Not at all!」	「もちろんです！」	Not at all!	「もちろんです！」
「I always go alone, so...」	「いつも一人で行っているので……」	I always go alone, so...	「いつも一人で行っているので……」
「Yeah, me too...」	「わたしも……」	Yeah, me too...	「アタシも……」
「This is so cute~!」	「この状況、すっごくかわいくない～！？」	This is so cute~!	「この状況、すっごくかわいくない～！？」
「Sayori, shut up...」	「サヨリ、お前は黙ってろ……」	Sayori, shut up...	「サヨリ、お前は黙ってろ……」
「I'll show you some manga there too, okay?」	「そこでいくつかマンガをおすすめするわね？」	I'll show you some manga there too, okay?	「そこでいくつかマンガをおすすめするわね？」
「Yes.」	「分かりました」	Yes.	「はい」
「I look forward to it.」	「楽しみにしてますね」	I look forward to it.	「楽しみにしています」,Must
Natsuki and Yuri start to clean up the food.	ナツキとユリは食べ物を片付け始めた。	Natsuki and Yuri start to clean up the food.	ナツキとユリは食べ物を片付け始めた。
「Ehehe~」	「えへへ～」	Ehehe~	「えへへ～っ」
「I guess the meeting's over, huh?」	「今日の部活はこれで終わりかな？」	I guess the meeting's over, huh?	「今日の部活はこれで終わりかな？」
「Yeah, looks like it...」	「ああ、そうみたいだな……」	Yeah, looks like it...	「ああ、そうみたいだな……」
「It's nice to see everyone getting along.」	「みんな仲良くやってるみたいで良かったよ」	It's nice to see everyone getting along.	「みんな仲良くやってるみたいで良かったよ」
「Isn't it?」	「そうだよねぇ～」	Isn't it?	「そうだよねぇ～」
「I think everyone likes you too, [player].」	「みんな[player]のことも好きだと思うよ」	I think everyone likes you too, [player].	「みんな[player]のことも好きだと思うよ」
「You think so...?」	「そうか……？」	You think so...?	「そうか……？」
「Well, everyone always seems to get along a little better with you around, Sayori.」	「まあ、サヨリがいるだけでみんなとの距離は縮まっていく気はするな」	Well, everyone always seems to get along a little better with you around, Sayori.	「まあ、サヨリがいるだけでみんなとの距離は縮まっていく気はするな」
「Aww, [player]~」	「もう、[player]は～」	Aww, [player]~	「もう、[player]は～」
「Don't say something like that, it's embarrassing!」	「そんなこと言われたら照れるでしょ～！」	Don't say something like that, it's embarrassing!	「そんなこと言われたら照れるでしょ～！」
「Well, whatever.」	「はいはい」	Well, whatever.	「まあ、いいか」
「I was surprised when you told me you were starting a club...」	「部活を立ち上げると聞いた時は正直驚いたが……」	I was surprised when you told me you were starting a club...	「部活を立ち上げると聞いた時は正直驚いたが……」
「But I think you're pulling it off just fine.」	「普通にうまくやれてるみたいだな」	But I think you're pulling it off just fine.	「普通にうまくやれてるみたいだな」
「We're gonna make it the best club ever!」	「みんなで最高の部活にしようね！」	We're gonna make it the best club ever!	「みんなで最高の部活にしようね！」
「Now that you joined, every day is gonna be so much fun.」	「[player]が加わったことで、毎日がさらに楽しくなるね」	Now that you joined, every day is gonna be so much fun.	「[player]が入ってくれたから、毎日がさらに楽しくなるよ」
「Hey, [player]...」	「ねぇ、[player]……」	Hey, [player]...	「ねえ、[player]……」
「I really want to thank you.」	「本当にありがとう」	I really want to thank you.	「本当にありがとう」
「I mean, I'm really happy that you joined the club and everything...」	「その、部活に入ってくれたことも本当に嬉しいんだけど……」	I mean, I'm really happy that you joined the club and everything...	「その、部活に入ってくれたことも本当にうれしいんだけど……」
「But the truth is, I already knew you were going to.」	「実はそれも最初から分かってたんだ」	But the truth is, I already knew you were going to.	「実はそれも最初からわかってたんだ」
「Ehehe~」	「えへへ～」	Ehehe~	「えへへ～っ」
「There's actually something else.」	「もう一つ伝えたいことがあるんだ」	There's actually something else.	「実は、もう一つ伝えたいことがあって」
「I wanted to thank you for getting rid of Monika.」	「モニカちゃんを消してくれてありがとう」	I wanted to thank you for getting rid of Monika.	「モニカちゃんを消してくれてありがとう」
「That's right...」	「そうだよ……」	That's right...	「あのね……」
「I know everything that she did.」	「モニカちゃんがしたこと、全部知ってるんだ」	I know everything that she did.	「モニカちゃんがしたこと、全部知ってるんだ」
「Maybe it's because I'm the President now.」	「わたしが部長になったからかな」	Maybe it's because I'm the President now.	「わたしが部長になったからかな」
「But I really know everything, [player].」	「でもほんとに全部知ってるんだよ、[player]」	But I really know everything, [player].	「でも、ホントに全部知ってるんだよ、[player]」
「Ehehe~」	「えへへ～」	Ehehe~	「えへへ～っ」
「I know how hard you tried to make everyone happy.」	「[player]がみんなを幸せにするためにどんなに頑張ったか知ってるよ」	I know how hard you tried to make everyone happy.	「[player]がみんなを幸せにするために、どんなにがんばったか知ってるよ」
「I know about all of the awful things that Monika did to make everyone really sad...」	「モニカちゃんがみんなを悲しませるためにひどい事をしたのも、全部……」	I know about all of the awful things that Monika did to make everyone really sad...	「モニカちゃんがみんなを悲しませるためにひどいことをしたのも、全部……」
「But none of that matters anymore.」	「でも、そんなのもうどうでもいいよね」	But none of that matters anymore.	「でも、そんなのもうどうでもいいよね」
「It's just us now.」	「もう二人きりだし」	It's just us now.	「もう、二人きりだし」
「It's just us now.」	「もう二人きりだし」	It's just us now.	「もう、二人きりだし」
「And you made me the happiest girl in the whole world.」	「[player]がいるとわたしは世界一幸せな女の子になれるんだよ」	And you made me the happiest girl in the whole world.	「[player]がいると、わたしは世界一幸せな女の子になれるんだよ」
「I can't wait to spend every day like this...」	「こうやって毎日過ごすのがすっごく楽しみだなぁ……」	I can't wait to spend every day like this...	「こうやって毎日過ごすのがすっごく楽しみだなぁ……」
「With you.」	「[player]と」	With you.	「サヨリとならね」
「Forever and ever...」	「ずっと永遠に」	Forever and ever...	「ずっと永遠に」
「F」	「ず」	F	「ず」
「o」	「っ」	o	「っ」
「r」	「と」	r	「と」
「e」	「え」	e	「え」
「v」	「い」	v	「い」
「e」	「え」	e	「え」
「...Eh?」	「……えっ？」	...Eh?	「……んっ？」
「W-What's happening...?」	「な、何が起きてるの……？」	W-What's happening...?	「な、何が起きてるの……？」
「Who...」	「誰……」	Who...	「誰……」
「I-It hurts--」	「い、痛い――」	I-It hurts--	「い、痛い――」
「Ah--」	「あ――」	Ah--	「えっと……」
「[gtext]」	「[gtext]」	[gtext]	[gtext]
「I wanted to thank you for spending so much time with us all.」	「みんなとたくさんの時間を過ごしてくれてありがとう」	I wanted to thank you for spending so much time with us all.	「みんなとたくさんの時間を過ごしてくれてありがとう」
「You worked so hard to make each and every one of us happy.」	「一人一人が幸せになれるように本当に頑張ってくれたよね」	You worked so hard to make each and every one of us happy.	「一人ひとりが幸せになれるように本当にがんばってくれたよね」
「You comforted us through our hard times.」	「大変な時もずっとそばにいてくれたよね」	You comforted us through our hard times.	「大変な時もずっとそばにいてくれたよね」
「And you helped us all get along with each other.」	「みんなの絆も深めてくれたよね」	And you helped us all get along with each other.	「みんなの絆も深めてくれたよね」
「Do you get it, [player]?」	「わかる、[player]？」	Do you get it, [player]?	「わかるかな、[player]？」
「Because I'm President now, I understand everything.」	「部長になった今、わたし全部知ってるんだ」	Because I'm President now, I understand everything.	「部長になった今、わたし全部知ってるんだ」
「You really didn't want to miss a single thing in this game, did you?」	「このゲームの内容を何一つ見落としたくなかったんだよね？」	You really didn't want to miss a single thing in this game, did you?	「このゲームの内容を何一つ見落としたくなかったんだよね？」
「You saved and loaded so many times, just to make sure you could spend time with everyone.」	「みんなと一緒に過ごせるように、何度もセーブとロードを繰り返してくれて……」	You saved and loaded so many times, just to make sure you could spend time with everyone.	「みんなと一緒に過ごせるように、何度もセーブとロードを繰り返してくれて……」
「Only someone who truly cares about the Literature Club would go that far.」	「心の底から文芸部が好きな人じゃないと絶対にできないことだよ」	Only someone who truly cares about the Literature Club would go that far.	「心の底から文芸部が好きな人じゃないと絶対にできないことだよ」
「But...」	「でも……」	But...	「けど……」
「All along, that's all I ever wanted.」	「これが、初めからわたしの一番の望みだったんだ」	All along, that's all I ever wanted.	「これが、初めからわたしの一番の望みだったんだ」
「For everyone to be happy and care about each other.」	「みんな幸せで、お互いを思い合う仲になることが」	For everyone to be happy and care about each other.	「みんな幸せで、お互いを思いやる仲になることが」
「Ahaha...」	「あはは……」	Ahaha...	「そうだな……」
「It's kind of sad, you know?」	「ちょっと悲しいな」	It's kind of sad, you know?	「ちょっと悲しいな」
「After all you've done for us, there isn't much I can do for you in return.」	「こんなにもいっぱい頑張ってくれたのに、お返しできることがあまりないんだもん」	After all you've done for us, there isn't much I can do for you in return.	「いっぱいがんばってくれたのに、お返しできることがあまりないんだもん」
「We've already reached the end of the game.」	「それに、もうゲームの終わりに辿り着いちゃった」	We've already reached the end of the game.	「それに、もうゲームの終わりに辿り着いちゃった」
「So...」	「だから……」	So...	「それで……」
「This is where we say goodbye.」	「ここでお別れだね」	This is where we say goodbye.	「ここでお別れだね」
「Thank you for playing <i>Doki Doki Literature Club</i>.」	「<i>Doki Doki Literature Club</i>を遊んでくれてありがとう」	Thank you for playing <i>Doki Doki Literature Club</i>.	「<i>ドキドキ文芸部</i>を遊んでくれてありがとう」
「I'm going to miss you, [player].」	「寂しくなるね、[player]」	I'm going to miss you, [player].	「寂しくなるよ、[player]」
「Come visit sometime, okay?」	「また遊びにきてね？」	Come visit sometime, okay?	「また遊びに来てね？」
「We'll always be here for you.」	「みんなここにいるから」	We'll always be here for you.	「みんなここにいるから」
「We...」	「みんな……」	We...	「みんな……」
「We all love you.」	「みんな[player]が大好きだから」	We all love you.	「みんな[player]が大好きだから」
