「Okay, everyone!」	「よし、みんな！」	Okay, everyone!	「よし、みんな！」
「We're all done reading each other's poems, right?」	「もうお互いの詩を読み終わったわよね？」	We're all done reading each other's poems, right?	「もうお互いの詩を読み終わったわよね？」
「I have something extra planned today, so if everyone could come sit at the front of the room...」	「今日はもうひとつやることがあるから、みんな部屋の前の方まで来てくれる？」	I have something extra planned today, so if everyone could come sit at the front of the room...	「今日はもう一つやることがあるから、みんな部屋の前の方まで来てくれる？」
「Is this about the festival?」	「文化祭に関係あること？」	Is this about the festival?	「文化祭に関係あること？」
「Well, sort of~」	「ええ、まあね」	Well, sort of~	「ええ、まあね」
「Ugh. Do we really have to do something for the festival?」	「うう……本当に文化祭で何かしなきゃいけないわけ？」	Ugh. Do we really have to do something for the festival?	「うう……本当に文化祭で何かしなきゃいけないわけ？」
「It's not like we can put together anything good in just a few days.」	「あと数日しかないのに何かやろうとしたって、何もできっこないわよ」	It's not like we can put together anything good in just a few days.	「あと数日しかないのに何かやろうとしたって、できっこないわよ」
「We'll just end up embarrassing ourselves instead of getting any new members.」	「新入部員も入ってこない上に恥をかくだけよ」	We'll just end up embarrassing ourselves instead of getting any new members.	「新入部員も入ってこない上に恥をかくだけよ」
「That's a concern of mine as well.」	「私も心配です」	That's a concern of mine as well.	「私も心配です」
「I don't really do well with last-minute preparations...」	「あまり時間がない状況で準備するなんて、うまくやれないですし……」	I don't really do well with last-minute preparations...	「あまり時間がない状況で準備するなんて、うまく行くかどうか……」
「Don't worry so much!」	「そんなに心配しないで！」	Don't worry so much!	「心配しないで！」
「We're going to keep it simple, okay?」	「簡単なことにするから、ね？」	We're going to keep it simple, okay?	「簡単なことにするから、ね？」
「We won't need much more than a few decorations.」	「いくらか飾り付けをする以外は特に準備は必要ないから」	We won't need much more than a few decorations.	「いくらか飾りつけをする以外は特に準備は必要ないから」
「Sayori has been working on posters, and I've designed some pamphlets we can give out during the event.」	「サヨリがポスターを作ってくれてるし、私も文化祭で配るパンフレットをデザインしておいたから」	Sayori has been working on posters, and I've designed some pamphlets we can give out during the event.	「サヨリがポスターをつくってくれてるし、私も文化祭で配るパンフレットをデザインしておいたから」
「Okay, that's great and all...」	「それはいいけど……」	Okay, that's great and all...	「それはいいけど……」
「But that doesn't tell us what we're actually going to be doing for the event.」	「まだ文化祭で何をやろうとしているのか言ってもらってないんだけど」	But that doesn't tell us what we're actually going to be doing for the event.	「文化祭で何をやろうとしているのか、まだ聞いてないんだけど」
「Ah, sorry! I thought you heard about it already.」	「あ、ごめん！ てっきりもう聞いていると思ってたわ」	Ah, sorry! I thought you heard about it already.	「あ、ごめん！ てっきりもう聞いていると思ってたわ」
「We're going to be performing!」	「発表をするのよ！」	We're going to be performing!	「発表をするのよ！」
「Performing?」	「発表？」	Performing?	「発表？」
「P...」	「は……」	P...	「は……」
「Um, Monika...」	「モ、モニカちゃん……」	Um, Monika...	「モ、モニカちゃん……」
「Yeah! We're going to be having a poetry performance.」	「そう！ 詩の発表をするの」	Yeah! We're going to be having a poetry performance.	「そう！ 詩の発表をするの」
「Each of us are going to choose a poem to recite during the event.」	「みんなそれぞれ詩を選んで、来てくれた人の前で読み上げるの」	Each of us are going to choose a poem to recite during the event.	「みんなそれぞれ詩を選んで、来てくれた人の前で読み上げるの」
「But the cool part is, we're also going to let anyone else come up and recite poems too!」	「さらに、それを聞いてやりたくなった人がいたら、その人たちにもそれをやってもらうの！」	But the cool part is, we're also going to let anyone else come up and recite poems too!	「さらに、それを聞いてやりたくなった人がいたら、その人たちにもそれをやってもらうの！」
「Sayori's putting it on all the posters in case anyone wants to prepare ahead of time.」	「準備をしておきたい人がいるかもしれないし、サヨリもポスターにそのことを書いてくれているわ」	Sayori's putting it on all the posters in case anyone wants to prepare ahead of time.	「準備をしておきたい人がいるかもしれないし、サヨリもポスターにそのことを書いてくれているわ」
「Ehehe~」	「えへへ～」	Ehehe~	「うふふ」
Sayori, who's been coloring a poster, holds it up for us to see.	ポスターに色を塗っていたサヨリは、それをこちらに広げて見せる。	Sayori, who's been coloring a poster, holds it up for us to see.	ポスターに色を塗っていたサヨリは、それをこちらに広げて見せる。
「Are you kidding me, Monika?」	「冗談でしょ、モニカ？」	Are you kidding me, Monika?	「冗談でしょ、モニカ？」
「You didn't...you didn't already start putting those posters up, did you?」	「まさかとは思うけど……そのポスターをもう貼り出したりはしてないわよね？」	You didn't...you didn't already start putting those posters up, did you?	「まさかとは思うけど……そのポスターをもう貼り出したりはしてないわよね？」
「Eh? Well, I did...」	「え？ してるけど……」	Eh? Well, I did...	「え？ してるけど……」
「Do you really think it's that bad of an idea...?」	「そんなにダメだったかしら、このアイデア……？」	Do you really think it's that bad of an idea...?	「そんなにダメだったかしら、このアイデア……？」
「Well, no.」	「いや、そうじゃなくて……」	Well, no.	「いや、そうじゃなくて……」
「It's not a bad idea.」	「アイデアそのものは悪くないと思うわ」	It's not a bad idea.	「アイデアそのものは悪くないと思うわ」
「But I didn't sign up for this, you know!」	「でもわたしはそんなことやるとは言ってないわ！」	But I didn't sign up for this, you know!	「でもわたしはそんなことやるとは言ってない！」
「There is <i>no</i> way I'm going to be performing in front of a group of people like that!」	「そんなふうに観客の前で詩を読むなんて、ありえないから！」	There is <i>no</i> way I'm going to be performing in front of a group of people like that!	「そんな風に観客の前で詩を読むなんて、<i>ありえない</i>から！」
「I...I agree with Natsuki!」	「わ、私も……ナツキちゃんと同意見です！」	I...I agree with Natsuki!	「わ、私も……ナツキちゃんと同意見です！」
「I could never...in my life...do something like that...」	「そんな大それたこと……絶対にできません……」	I could never...in my life...do something like that...	「そんな大それたこと……絶対にできません……」
Imagining it, Yuri shakes her head in fear.	その光景を想像したのだろう、ユリは恐怖で首を振っている。	Imagining it, Yuri shakes her head in fear.	その光景を想像したのだろう、ユリは恐怖で首を振っている。
「Guys...」	「みんな……」	Guys...	「みんな……」
「No, Sayori...」	「ううん、いいのよ、サヨリ……」	No, Sayori...	「ううん、いいのよ、サヨリ……」
「I understand where they're coming from.」	「二人がそう考えるのも無理はないわ」	I understand where they're coming from.	「二人がそう考えるのも無理はないわ」
「Remember that Natsuki and Yuri have never shared their poems with anyone until just a couple days ago...」	「二人ともたった数日前に他の人に詩を見せることを始めたばかりなんだから……」	Remember that Natsuki and Yuri have never shared their poems with anyone until just a couple days ago...	「二人とも、たった数日前に他の人に詩を見せることを始めたばかりなんだから……」
「It's a lot to ask for them to recite their poems out loud to a whole room full of people.」	「たくさんの人の前で詩を朗読しろだなんて、あまりにも荷が重すぎるわね」	It's a lot to ask for them to recite their poems out loud to a whole room full of people.	「たくさんの人の前で詩を朗読しろだなんて、あまりにも荷が重すぎるわね」
「I guess I kind of overlooked that.」	「私の考えが足りなかったわ」	I guess I kind of overlooked that.	「私の考えが足りなかったわ」
「So, I'm sorry.」	「本当にごめんなさい」	So, I'm sorry.	「本当にごめんなさい」
「...」	「……」	...	「……」
「...But!」	「……それでも！」	...But!	「……それでも！」
「I still think we should give it our best!」	「私たち、全力を尽くすべきだと思うの！」	I still think we should give it our best!	「私たち、全力を尽くすべきだと思うの！」
「We're the only ones responsible for the fate of this club.」	「この部活の運命は私たちに掛かっているのよ」	We're the only ones responsible for the fate of this club.	「この部活の運命は私たちにかかっているのよ」
「If we start the event and each put on a good performance...」	「もし最初にやる私たちの朗読がいいお手本になれば……」	If we start the event and each put on a good performance...	「もし最初にやる私たちの朗読がいいお手本になれば……」
「Then it will inspire others to do the same!」	「来てくれた人たちも『やってみたい』って思ってくれるはず！」	Then it will inspire others to do the same!	「来てくれた人たちも『やってみたい』って思ってくれるはず！」
「And the more people who perform, the better we'll be able to show everyone what literature is all about!」	「多くの人にやってもらえれば、それだけ多くの人に文学について知ってもらえるわ！」	And the more people who perform, the better we'll be able to show everyone what literature is all about!	「多くの人にやってもらえれば、それだけ多くの人に文学について知ってもらえるわ！」
「Yeah!」	「そうだね！」	Yeah!	「いいね！」
「It's about expressing your feelings...」	「文学って、自分の感情の表現だったり……」	It's about expressing your feelings...	「文学って、自分の感情の表現だったり……」
「Being intimate with yourself...」	「自分についてより深く理解できることだったり……」	Being intimate with yourself...	「自分についてより深く理解できることだったり……」
「Finding new horizons...」	「未知の領域を見つけることだったり……」	Finding new horizons...	「未知の領域を見つけることだったり……」
「And having fun!」	「楽しむことだからね！」	And having fun!	「楽しむことだからね！」
「That's right!」	「そう！」	That's right!	「そう！」
「And it's those reasons that we're all in this club today.」	「私たちがこの部にいる理由も同じ」	And it's those reasons that we're all in this club today.	「私たちがこの部にいる理由も同じ」
「Don't you want to share that with others?」	「この理由を他の人たちにも知ってもらいたくないかしら？」	Don't you want to share that with others?	「これを、他の人たちにも知ってもらいたくないかしら？」
「To inspire them to find the same feelings that brought you here in the first place?」	「私たちを文芸部へと導いたこの気持ちをその人たちにも見つけてほしいとは思わない？」	To inspire them to find the same feelings that brought you here in the first place?	「私たちを文芸部へと導いたこの気持ちを、その人たちにも見つけてほしいとは思わない？」
「I know you do.」	「きっとそう思っているはず」	I know you do.	「きっとそう思っているはず」
「I know we all do.」	「私たちみんな、そう思っているはず」	I know we all do.	「私たちみんな、そう思っているはず」
「And if all it takes is standing in front of the room for two minutes and reciting a poem...」	「それが部屋の前に立って、たった二分間詩を朗読するだけで可能になるなら……」	And if all it takes is standing in front of the room for two minutes and reciting a poem...	「それが部屋の前に立って、たった二分間詩を朗読するだけで可能になるなら……」
「...Then I know you can do it!」	「きっとみんなできるはず！」	...Then I know you can do it!	「きっとみんなできるはず！」
「...」	「……」	...	「……」
「...」	「……」	...	「……」
Natsuki and Yuri remain silent.	ナツキとユリは黙ったままだ。	Natsuki and Yuri remain silent.	ナツキとユリは黙ったままだ。
Sayori looks worried.	サヨリは心配そうな表情を浮かべている。	Sayori looks worried.	サヨリは心配そうな表情を浮かべている。
I guess that leaves me no choice...	どうやら、俺が取るべき手段はひとつのようだ……。	I guess that leaves me no choice...	どうやら、俺が取るべき手段は一つのようだ……。
「I agree...」	「俺は賛成だ……」	I agree...	「俺は賛成だ……」
「I don't think it's too much to ask.」	「決して無理な要求とは思えない」	I don't think it's too much to ask.	「決して無理な要求とは思えない」
「I think that Sayori and Monika have been trying really hard to get new members.」	「サヨリとモニカは新入部員獲得のために全力を尽くしてくれている」	I think that Sayori and Monika have been trying really hard to get new members.	「サヨリとモニカは新入部員獲得のために全力を尽くしてくれてる」
「The least we can do is help them out a little bit.」	「俺たちも少しぐらい手伝うべきなんじゃないか」	The least we can do is help them out a little bit.	「俺たちも少しぐらい手伝うべきなんじゃないか」
「Well...maybe, but...」	「それは……そうかもしれないけど……」	Well...maybe, but...	「それは……そうかもしれないけど……」
「...」	「……」	...	「……」
It looks like Natsuki doesn't have any arguments left.	ナツキはそれ以上反論の言葉が無いようだ。	It looks like Natsuki doesn't have any arguments left.	ナツキはそれ以上反論の言葉が無いようだ。
「Uu...」	「うう……」	Uu...	「うう……」
「...Okay, fine!」	「……もう、わかったわよ！」	...Okay, fine!	「……もう、わかったわよ！」
「I guess I'll just have to get it over with.」	「どうせやるなら早く済ませるしかないわね」	I guess I'll just have to get it over with.	「どうせやるなら早く済ませるしかないわね」
「Alright~!」	「やった～！」	Alright~!	「やった～！」
「Phew...」	「ふう……」	Phew...	「ふぅ……」
「Thanks, Natsuki.」	「ありがとう、ナツキ」	Thanks, Natsuki.	「ありがとう、ナツキ」
「What about you, Yuri...?」	「あなたはどうかしら、ユリ……？」	What about you, Yuri...?	「あなたはどうかしら、ユリ……？」
「...」	「……」	...	「……」
Yuri dejectedly glances around at everyone else's expectant faces.	ユリは気落ちした様子でみんなの期待した顔を見ている。	Yuri dejectedly glances around at everyone else's expectant faces.	ユリは気落ちした様子で、みんなの期待した顔を見ている。
「Sigh...」	「はあ……」	Sigh...	「はあ……」
「I-I guess I don't really have a choice...」	「も、もう、やるしかないようですね……」	I-I guess I don't really have a choice...	「も、もう、やるしかないようですね……」
「Ahaha! That's everyone!」	「あはは！ これでみんな揃ったね！」	Ahaha! That's everyone!	「あはは！ これでみんな揃ったね！」
「You're the best, Yuri~」	「最高だよ、ユリちゃん～！」	You're the best, Yuri~	「最高だよ、ユリちゃん～！」
「This club is seriously going to be the death of me...」	「この部にいると、私そのうち死んでしまうかも……」	This club is seriously going to be the death of me...	「この部にいると、私そのうち死んでしまうかも……」
「Oh gosh...」	「そんな大げさな……」	Oh gosh...	「あらあら……」
「You'll be fine, Yuri.」	「大丈夫よ、ユリ」	You'll be fine, Yuri.	「大丈夫よ、ユリ」
「But anyway...」	「まあとにかく……」	But anyway...	「それで……」
「Let's move onto the main event!」	「メインイベントへ移りましょう！」	Let's move onto the main event!	「メインイベントへ移りましょう！」
「I want each of you to choose a poem of yours.」	「みんな、自分の詩の中からひとつを選んで」	I want each of you to choose a poem of yours.	「みんな、自分の詩の中から一つを選んで」
「We're going to practice reciting them in front of each other.」	「お互いの前で朗読して、発表の練習をしましょう」	We're going to practice reciting them in front of each other.	「お互いの前で朗読して、発表の練習をしましょう」
「N-N-No way!!」	「い、いいい、嫌よ！」	N-N-No way!!	「い、いいい、嫌よ！」
「Monika...!」	「モニカちゃん……！」	Monika...!	「モニカちゃん……！」
「This is too sudden...!」	「それはあまりにも急すぎます……！」	This is too sudden...!	「それはあまりにも急すぎます……！」
「Well, if you can't recite your poem in front of the club, how do you expect to do it in front of strangers?」	「でも部のみんなの前でさえできないんだったら、知らない人の前でなんて到底できないでしょ？」	Well, if you can't recite your poem in front of the club, how do you expect to do it in front of strangers?	「でも部のみんなの前でさえできないんだったら、知らない人の前でなんて到底できないでしょ？」
「Oh no...」	「ああ……もう……」	Oh no...	「どうして……」
「Don't worry.」	「心配しないで」	Don't worry.	「心配しないで」
「I'll start off to help everyone feel a little more comfortable.」	「みんながやりやすいように、まず私からやってみるから」	I'll start off to help everyone feel a little more comfortable.	「みんながやりやすいように、まず私からやってみるから」
「Can I go next??」	「その次わたしがやっていい？」	Can I go next??	「その次わたしがやっていい？」
「Ahaha. Of course.」	「あはは、もちろん」	Ahaha. Of course.	「あはは、もちろん」
「Now, let's see...」	「さて、それじゃあ……」	Now, let's see...	「さて、それじゃあ……」
Monika flips through her notebook to the specific poem she has in mind for herself.	モニカはノートをめくり、読み上げるための詩を探す。	Monika flips through her notebook to the specific poem she has in mind for herself.	モニカはノートをめくり、読み上げるための詩を探す。
She then stands behind the podium.	そしてモニカは教卓の後ろに立つ。	She then stands behind the podium.	そして教卓の後ろに立つ。
「The title of this poem is <i>The Way They Fly</i>.」	「この詩のタイトルは『彼らの羽ばたいていくところ』よ」	The title of this poem is <i>The Way They Fly</i>.	「この詩のタイトルは<i>『彼らの羽ばたいていくところ』</i>よ」
「Ahem...」	「コホン……」	Ahem...	「コホン……」
Monika begins reciting her poem.	モニカは朗読を始める。	Monika begins reciting her poem.	モニカは朗読を始める。
Her clear, confident voice fills the room.	明瞭で自信に満ちた声が部屋を満たす。	Her clear, confident voice fills the room.	明瞭で自信に満ちた声が部屋を満たす。
More than that, her inflection is pristine.	またそれ以上に、抑揚の付け方が純真そのものだ。	More than that, her inflection is pristine.	またそれ以上に、抑揚の付け方が純真そのものだ。
She knows exactly how to apply emotion behind each line she recites, bringing the words to life.	それぞれの行ごとにどのように感情を乗せればいいのかを正確に理解していて、言葉に命が吹き込まれているかのようだ。	She knows exactly how to apply emotion behind each line she recites, bringing the words to life.	それぞれの行ごとに、どう感情を乗せればいいのかを正確に理解していて、言葉に命が吹き込まれているかのようだ。
Is this something she's done before, or is she simply a natural?	これは以前に朗読の経験があるのか、それとも才能の為せる業なのか。	Is this something she's done before, or is she simply a natural?	これは以前に朗読の経験があるのか、それとも才能の為せる業なのか。
I glance around me.	俺は周りを見回す。	I glance around me.	俺は周りを見回す。
Everyone has their eyes on Monika.	みんなモニカに目を奪われている。	Everyone has their eyes on Monika.	みんなモニカに目を奪われている。
Sayori looks amazed.	サヨリは驚いている。	Sayori looks amazed.	サヨリは驚いている。
Yuri has an intense expression on her face that I don't understand.	ユリは、俺にはその意味が理解できないものの、どこか情熱的な表情を浮かべている。	Yuri has an intense expression on her face that I don't understand.	ユリは、俺にはその意味が理解できないものの、どこか情熱的な表情を浮かべている。
Finally, Monika finishes the recitation.	そして、モニカは詩を読み終えた。	Finally, Monika finishes the recitation.	そして、モニカは詩を読み終えた。
The four of us applaud.	俺たち４人は拍手喝采する。	The four of us applaud.	俺たち４人は拍手喝采する。
Monika takes a breath and smiles.	モニカはひとつ息を吐き、微笑んだ。	Monika takes a breath and smiles.	モニカは一つ息を吐き、微笑んだ。
「That...that was so good, Monika!」	「す……すっごくよかったよー、モニカちゃん！」	That...that was so good, Monika!	「す……すっごくよかったよー、モニカちゃん！」
「Ahaha, thank you very much.」	「あはは、どうもありがとう」	Ahaha, thank you very much.	「あはは、どうもありがとう」
「I was just hoping to set a good example.」	「なんとかしていいお手本となりたくてね」	I was just hoping to set a good example.	「何とかしていいお手本になりたくてね」
「Are you ready to go next, Sayori?」	「次はサヨリの番よね？」	Are you ready to go next, Sayori?	「次はサヨリの番よね？」
「I...I'll go next!!」	「わ……私がやります！」	I...I'll go next!!	「わ……私がやります！」
「Uwah! Yuri's fired up all of a sudden!」	「うわ！ ユリちゃんが突然やる気になった！」	Uwah! Yuri's fired up all of a sudden!	「うわ！ ユリちゃんが突然やる気になった！」
Yuri clutches a sheet of paper between her hands and stands up.	ユリは一枚の紙を手に立ち上がる。	Yuri clutches a sheet of paper between her hands and stands up.	ユリは一枚の紙を手に立ち上がる。
Keeping her head down, she walks quickly over to the podium.	俯きがちに、教卓へと足早に向かう。	Keeping her head down, she walks quickly over to the podium.	俯きがちに、教卓へと足早に向かう。
「This poem is called--!」	「この詩は……！」	This poem is called--!	「この詩は……！」
Yuri anxiously glances at each of us.	ユリは心細げに俺たちの方を見る。	Yuri anxiously glances at each of us.	ユリは心細げに俺たちの方を見る。
「You can do it, Yuri...」	「頑張れ、ユリちゃん……」	You can do it, Yuri...	「がんばれ、ユリちゃん……」
「It...It's called...<i>Afterimage of a Crimson Eye</i>.」	「こ……この詩は……『真紅の瞳の残像』という題名です」	It...It's called...<i>Afterimage of a Crimson Eye</i>.	「こ……この詩は……<i>『真紅の瞳の残像』</i>という題名です」
Yuri's voice shakes as she starts reading the poem.	ユリが読み始めるが、声が震えている。	Yuri's voice shakes as she starts reading the poem.	ユリが読み始めるが、声が震えている。
Just a moment ago, she practically refused to do this.	ユリはほんのつい先程まで、こういうことをするのを拒んでいた。	Just a moment ago, she practically refused to do this.	ユリはほんのつい先程まで、こういうことをするのを拒んでいた。
Why is she suddenly putting in so much effort?	それが何故突然やる気に満ち溢れるようになったのだろうか？	Why is she suddenly putting in so much effort?	それが何故突然やる気に満ち溢れるようになったのだろうか？
As Yuri gets past the first couple of lines, her voice changes.	けれども数行を読み終えると、ユリの声が変わった。	As Yuri gets past the first couple of lines, her voice changes.	けれども数行を読み終えると、ユリの声が変わった。
It's almost like what happens when Yuri gets absorbed into her books.	ユリが本に熱中するときのあの様子と同じだ。	It's almost like what happens when Yuri gets absorbed into her books.	ユリが本に熱中するときのあの様子と同じだ。
Her quivering words transform into the sharp syllables of a fierce and confident woman.	震えていた声は、強く自信を持った女性のそれへと変化していく。	Her quivering words transform into the sharp syllables of a fierce and confident woman.	震えていた声は、強く自信を持った女性のそれへと変化していく。
The poem is full of twists and turns in its structure that she enunciates with perfect timing.	詩は紆余曲折な構造だが、ユリはそれを完璧なタイミングの取り方で読んでいく。	The poem is full of twists and turns in its structure that she enunciates with perfect timing.	詩は紆余曲折な構造だが、ユリはそれを完璧なタイミングの取り方で読んでいく。
This must be a rare glimpse into the whirling fire Yuri keeps concealed inside her head...!	こういうふうにユリの中に渦巻く炎とでも言うべきものが垣間見えるというのは珍しいことだ。	This must be a rare glimpse into the whirling fire Yuri keeps concealed inside her head...!	こういうふうにユリの中に渦巻く炎とでも言うべきものが垣間見えるというのは、珍しいことだ。
Suddenly, she's finished.	不意に、ユリは読み終えた。	Suddenly, she's finished.	不意に、ユリは読み終えた。
Everyone is stunned.	みんな呆然としている。	Everyone is stunned.	みんな呆然としている。
Yuri snaps back into reality and glances around her, as if she bewildered even herself.	ユリは我に返り、自分自身も困惑しているかのように辺りを見る。	Yuri snaps back into reality and glances around her, as if she bewildered even herself.	ユリは我に返り、自分自身も困惑しているかのように辺りを見る。
「I...」	「わ、私……」	I...	「アタシは……」
...It's up to me to save this situation.	……この状況を打開するのは俺しかいないようだ。	...It's up to me to save this situation.	……この状況を打開するのは俺しかいないようだ。
I'm the first to start applauding.	最初に俺が拍手をおくる。	I'm the first to start applauding.	最初に俺が拍手をおくる。
Everyone joins me afterward, and we give Yuri the recognition she deserves.	みんながそれに加わり、ユリにふさわしい賞賛がおくられる。	Everyone joins me afterward, and we give Yuri the recognition she deserves.	みんながそれに加わり、ユリにふさわしい賞賛がおくられる。
It's not that we didn't want to applaud for her.	なにも俺たちは拍手をしたくなかったわけじゃない。	It's not that we didn't want to applaud for her.	俺たちは、何も拍手をしたくなかったわけじゃない。
But we were caught so off-guard that we must have forgotten.	ただあまりのことに不意を突かれて忘れていただけだ。	But we were caught so off-guard that we must have forgotten.	ただあまりのことに不意を突かれて忘れていただけだ。
As we applaud, Yuri holds the poem to her chest and rushes back into her seat.	俺たちが拍手をしていると、ユリは詩の書いてある紙を胸に自分の席に急いで戻る。	As we applaud, Yuri holds the poem to her chest and rushes back into her seat.	俺たちが拍手をしていると、ユリは詩の書いてある紙を胸に自分の席に急いで戻る。
「Yuri, that was really good.」	「ユリ、とてもよかったわよ」	Yuri, that was really good.	「ユリ、とてもよかったわよ」
「Thank you for sharing.」	「読んでくれてありがとう」	Thank you for sharing.	「読んでくれてありがとう」
「...」	「……」	...	「……」
Looks like Yuri is down for the count...	ユリはここでダウンのようだ……	Looks like Yuri is down for the count...	ユリはここでダウンのようだ……
「Okaay~」	「よぉ～し！」	Okaay~	「よぉ～し！」
「I guess I'm next, then!」	「次はわたしだね！」	I guess I'm next, then!	「次はわたしだね！」
Sayori hops out of her chair and cheerfully walks to the podium.	サヨリは椅子から勢いよく立ち上がると、元気よく教卓へ向かう。	Sayori hops out of her chair and cheerfully walks to the podium.	サヨリは椅子から勢いよく立ち上がると、元気よく教卓へ向かう。
「This one's called...<i>My Meadow</i>.」	「この詩の名前は……『平原』」	This one's called...<i>My Meadow</i>.	「この詩の名前は……<i>『平原』</i>」
「Ah...」	「ふ……」	Ah...	「あのね……」
「...Ahaha!」	「ふふふっ！」	...Ahaha!	「ふふふっ！」
「Sorry, I giggled...」	「ごめん、笑っちゃった……」	Sorry, I giggled...	「ごめん、笑っちゃった……」
「Ehehe...」	「えへへ……」	Ehehe...	「だから……えへへ……」
「Sayori...」	「サヨリ……」	Sayori...	「……サヨリ……」
「It's a lot harder than I thought!」	「これ思ってたよりずっと難しいよ！」	It's a lot harder than I thought!	「これ思ってたよりずっと難しいよ！」
「How did you guys do it so easily?」	「みんなどうやってあんな簡単にできたの？」	How did you guys do it so easily?	「みんなどうしてあんな簡単にできたの？」
「Ah...」	「ああ……」	Ah...	「ああ……」
「Try not to think of it like you're reciting to other people.」	「人の前で朗読していると考えないようにしてみて」	Try not to think of it like you're reciting to other people.	「人の前で朗読していると考えないようにしてみて」
「Imagine you're reciting it to yourself, like in front of a mirror, or in your own head.」	「一人で鏡に向かってるとか、心の中で読み上げてるとか思い込むの」	Imagine you're reciting it to yourself, like in front of a mirror, or in your own head.	「一人で鏡に向かってるとか、心の中で読み上げてるとか思い込むの」
「It's your poem, so it'll come out the best that way.」	「あなたの詩なんだから、そうすればきっとうまくいくわ」	It's your poem, so it'll come out the best that way.	「あなたの詩なんだから、そうすればきっとうまくいくわ」
「I see, I see...」	「なるほど、なるほど……」	I see, I see...	「なるほど、なるほど……」
「Okay, then...」	「よーし、それじゃ……」	Okay, then...	「よーし、それじゃ……」
Sayori begins her poem.	サヨリは詩を読み始める。	Sayori begins her poem.	サヨリは詩を読み始める。
Somehow, it feels like her soft voice was made as a perfect match.	サヨリの柔らかな声は、どういうわけかその詩に完璧に合っているように思われる。	Somehow, it feels like her soft voice was made as a perfect match.	サヨリの柔らかな声は、どういうわけかその詩に完璧に合っているように思われる。
The poem isn't aimlessly cheery like Sayori is.	詩はサヨリ本人のようにふらふらとしていながらも元気な感じではない。	The poem isn't aimlessly cheery like Sayori is.	詩はサヨリ本人のようにふらふらとしていながらも元気な感じではない。
It's serene and bittersweet.	穏やかでいて、ほろ苦い詩だ。	It's serene and bittersweet.	穏やかでいて、ほろ苦い詩だ。
If I were to read this on paper, I probably wouldn't think much of it...	もし紙に書かれているのを読んだとしても、そこまで感心はしないだろう。	If I were to read this on paper, I probably wouldn't think much of it...	もし紙に書かれているのを読んだとしても、そこまで感心はしないだろう。
But hearing it come from Sayori's voice almost gives it a whole new meaning.	しかし朗読だと、サヨリの声が詩に全く新しい意味を与えていると言ってもいい。	But hearing it come from Sayori's voice almost gives it a whole new meaning.	しかし朗読だと、サヨリの声が詩にまったく新しい意味を与えていると言ってもいい。
Maybe this is what Sayori meant when she said she likes my poems.	サヨリが俺の詩を好きだと言ってくれたのも、こういうことが理由なのかもしれない。	Maybe this is what Sayori meant when she said she likes my poems.	サヨリが俺の詩を好きだと言ってくれたのも、こういうことが理由なのかもしれない。
It's like I get to reach more deeply into someone I thought I knew through and through.	自分が何もかも知っていると思っていた人の、ずっと深いところに触れるような感覚。	It's like I get to reach more deeply into someone I thought I knew through and through.	自分が何もかも知っていると思っていた人の、ずっと深いところに触れるような感覚。
Sayori finishes, and we applaud.	サヨリは読み終わり、俺たちは拍手をした。	Sayori finishes, and we applaud.	サヨリは読み終わり、俺たちは拍手をした。
「I did it~!」	「できたよ～！」	I did it~!	「やったよ～！」
「Good job, Sayori.」	「よくやった、サヨリ」	Good job, Sayori.	「よくやった、サヨリ」
「Ehehe, even [player] liked it.」	「えへへ、[player]も気に入ってくれた！」	Ehehe, even [player] liked it.	「えへへ、[player]も気に入ってくれた！」
「I guess that's a good sign~」	「つまり、かなりよかったってことだね～」	I guess that's a good sign~	「これはつまり、大成功ってことだね～」
「What does that even mean...?」	「どういう意味なんだ、それ……？」	What does that even mean...?	「どういう理屈だ、それ……？」
「It came out nicely, Sayori.」	「とても上手だったわよ、サヨリ」	It came out nicely, Sayori.	「とても上手だったわよ、サヨリ」
「The atmosphere of the poem fits you really nicely.」	「詩の雰囲気があなた自身と本当によく合っていて」	The atmosphere of the poem fits you really nicely.	「詩の雰囲気があなた自身と本当によく合っていて」
「But it might be that other poems wouldn't work quite as well with that kind of delivery...」	「でもその読み方は、他の詩を読むときにはあまりうまくいかないかもしれないわね……」	But it might be that other poems wouldn't work quite as well with that kind of delivery...	「でもその読み方は、他の詩を読むときにはあまりうまくいかないかもしれないわね……」
「Eh? I don't really understand...」	「え？ あまりよくわからないかも……」	Eh? I don't really understand...	「え？ あんまりよくわからないかも……」
「In other words, I've seen poems of yours where that sort of gentle delivery wouldn't work as well.」	「別の言い方をすれば、あなたの詩の中には優しい読み方だとうまく魅力が引き出せないものもあるってこと」	In other words, I've seen poems of yours where that sort of gentle delivery wouldn't work as well.	「別の言い方をすれば、あなたの詩の中には優しい読み方だとうまく魅力が引き出せないものもあるってこと」
「They might need a little more force behind them, depending on what you're reading...」	「読む詩によっては、もう少し力強く読むといい場合もあるかもね……」	They might need a little more force behind them, depending on what you're reading...	「読む詩によっては、もう少し力強く読むといい場合もあるかもね……」
「Oh, I know what you mean!」	「なるほど、そういう事ね！」	Oh, I know what you mean!	「なるほど、そういうことね！」
「That's...well, I've been practicing that kind of thing...」	「そういうのは……えっと、練習したりはしてるんだけど……」	That's...well, I've been practicing that kind of thing...	「そういうのは……えっと、練習したりはしてるんだけど……」
「It's just embarrassing to do in front of everyone...」	「みんなの前でやるのはちょっと恥ずかしくて……」	It's just embarrassing to do in front of everyone...	「みんなの前でやるのはちょっと恥ずかしくて……」
「Ehehe...」	「えへへ……」	Ehehe...	「えへへ……」
「Then next time, I'm going to make you pick a poem that challenges you a little more.」	「それなら次はもう少し練習になりそうな詩を選んでもらおうかしら」	Then next time, I'm going to make you pick a poem that challenges you a little more.	「それなら次はもう少し練習になりそうな詩を選んでもらおうかしら」
「We don't have much time before the festival, you know?」	「文化祭まであまり時間も無いものね」	We don't have much time before the festival, you know?	「文化祭まであまり時間もないものね」
「Okaaaaay.」	「オッケー！」	Okaaaaay.	「オッケー！」
「Now, who's next...?」	「それじゃあ、次は……？」	Now, who's next...?	「それじゃあ、次は……？」
「Natsuki?」	「ナツキ、どう？」	Natsuki?	「ナツキ、どう？」
「Hmph.」	「ふん」	Hmph.	「ふん」
「Don't make me go before [player].」	「[player]の前にやるなんてイヤ」	Don't make me go before [player].	「[player]の前にやるなんてイヤ」
「It's not like I can compare to you guys, anyway...」	「わたしはあんたたちみたいにうまくできないし……」	It's not like I can compare to you guys, anyway...	「アタシはアンタたちみたいにうまくできないし……」
「Might as well let [player] lower everyone's standards a little before I have to do it.」	「だからわたしがやる前に少しでもハードル下げておいてもらったほうがいいわ」	Might as well let [player] lower everyone's standards a little before I have to do it.	「だからアタシがやる前に少しでもハードル下げておいてもらった方がいいわ」
「Natsuki...」	「ナツキちゃん……」	Natsuki...	「ナツキ……」
「It's fine, it's fine.」	「いや、大丈夫だ」	It's fine, it's fine.	「大丈夫だ、問題ない」
「I might as well get it over with.」	「俺もなるべく早く終わらせたほうがいいと思ってたんだ」	I might as well get it over with.	「俺もなるべく早く終わらせた方がいいと思ってたんだ」
「But it's not like I have much of a selection of what to read...」	「でも俺には選べるほど詩が無いから……」	But it's not like I have much of a selection of what to read...	「でも俺には選べるほど詩がないから……」
「I'll just have to go with what I wrote for today.」	「今日のために書いてきたやつを読むことにするよ」	I'll just have to go with what I wrote for today.	「今日書いてきたやつを読むことにするよ」
I stand up and step in front of the podium.	俺は立ち上がり教卓の前へと歩を進める。	I stand up and step in front of the podium.	俺は立ち上がり、教卓へと歩を進める。
Everyone has their eyes on me, making me feel terribly awkward.	みんながこちらを見ていて、それがひどく俺をやりづらくさせる。	Everyone has their eyes on me, making me feel terribly awkward.	みんながこちらを見ていて、それがひどく俺をやりづらくさせる。
I recite my poem.	俺は詩を朗読した。	I recite my poem.	俺は詩を朗読した。
Since I'm not exactly confident in my own writing, it's hard to put energy into it.	書いている内容に自信を持てないのだから、感情を込めて読むことも難しい。	Since I'm not exactly confident in my own writing, it's hard to put energy into it.	書いている内容に自信を持てないのだから、感情を込めて読むことも難しい。
Despite that, once I finish, I receive applause anyway.	けれども読み終わると一応みんなから拍手は貰えた。	Despite that, once I finish, I receive applause anyway.	けれども読み終わると一応みんなから拍手はもらえた。
「Sorry I'm not really as good as everyone else...」	「すまん、この中じゃ俺が一番下手くそだな……」	Sorry I'm not really as good as everyone else...	「すまん、この中じゃ俺が一番下手くそだな……」
「Don't worry about it so much.」	「そんなに気にしないで」	Don't worry about it so much.	「そんなに気にしないで」
「I think it's less about your abilities, and more about your lack of confidence in your writing.」	「朗読の技術そのものよりも、自分の書いたものに自信を持てていないことのほうが問題かもしれないわね」	I think it's less about your abilities, and more about your lack of confidence in your writing.	「朗読の技術そのものよりも、自分の書いたものに自信を持てていないことの方が問題かもしれないわね」
「That's something that'll improve over time, though.」	「まあ、それも時が経てば身に付いてくるでしょうね」	That's something that'll improve over time, though.	「まあ、それも時間が経てば身に付いてくるでしょうね」
「Yeah... Maybe.」	「ああ……そうかもな」	Yeah... Maybe.	「ああ……そうかもな」
「Alright, then!」	「よし、それじゃあ！」	Alright, then!	「……わかったよ！」
「That just leaves you, Natsuki.」	「残りはあなただけよ、ナツキ」	That just leaves you, Natsuki.	「残りはあなただけよ、ナツキ」
「Yeah, yeah.」	「はいはい」	Yeah, yeah.	「はいはい」
「I'm going.」	「やればいいんでしょ」	I'm going.	「やればいいんでしょ」
Natsuki begrudgingly gets out of her seat and makes her way to the podium.	ナツキはしぶしぶ席を立ち、教卓へと歩く。	Natsuki begrudgingly gets out of her seat and makes her way to the podium.	ナツキはしぶしぶ席を立ち、教卓へと歩く。
「The poem is called...」	「この詩のタイトルは……」	The poem is called...	「この詩のタイトルは……」
「It's called...」	「タイトルは……」	It's called...	「タイトルは……」
「W-Why are you all looking at me?!」	「な、なんであんたたちそんなにこっちを見てるのよ！？」	W-Why are you all looking at me?!	「な、何でアンタたちそんなにこっちを見てるのよ！？」
「Because you're presenting...」	「あなたが発表してるからよ……」	Because you're presenting...	「あなたが発表してるからよ……」
「Hmph...」	「ふん……」	Hmph...	「ふん……」
「Anyway...the poem is called <i>Jump</i>.」	「まあいいわ……この詩のタイトルは『ジャンプ』よ」	Anyway...the poem is called <i>Jump</i>.	「まあいいわ……この詩のタイトルは<i>『ジャンプ』</i>よ」
Natsuki takes a breath.	ナツキは息を吸う。	Natsuki takes a breath.	ナツキは息を吸う。
Once she starts reciting the poem, her sour attitude disappears a little.	朗読が始まると、ナツキのひねくれた態度はいくぶん影を潜める。	Once she starts reciting the poem, her sour attitude disappears a little.	朗読が始まると、ナツキのひねくれた態度はいくぶん影を潜める。
While she's still a little unenthused, her poem has a rhythm and rhyme to it.	まだそれほど熱心に読んでいるというわけではないが、詩自体にはリズムがあり韻も踏んでいる。	While she's still a little unenthused, her poem has a rhythm and rhyme to it.	まだそれほど熱心に読んでいるというわけではないが、詩自体にはリズムがあり韻も踏んでいる。
It's Natsuki's trademark style, and it works surprisingly well when spoken aloud.	ナツキのトレードマークであるその文体は、声に出して読むとより一層効果を増す。	It's Natsuki's trademark style, and it works surprisingly well when spoken aloud.	ナツキのトレードマークであるその文体は、声に出して読むとより一層効果を増す。
The words feel like they bounce up and down, as if giving life to the poem.	まるで詩が命を与えられ、言葉が飛び跳ねているかのようだ。	The words feel like they bounce up and down, as if giving life to the poem.	まるで詩が命を与えられ、言葉が飛び跳ねているかのようだ。
Natsuki finishes, and everyone applauds.	ナツキが読み終え、みんなが拍手を贈る。	Natsuki finishes, and everyone applauds.	ナツキが読み終え、みんなが拍手をおくる。
She huffs back to her seat.	ナツキは不機嫌そうに自分の席へと戻る。	She huffs back to her seat.	彼女は不機嫌そうに自分の席へと戻る。
「That wasn't so bad, was it?」	「そんなに難しいことじゃなかったでしょ？」	That wasn't so bad, was it?	「そんなに難しいことじゃなかったでしょ？」
「Easy for you to say...」	「簡単に言ってくれるわね……」	Easy for you to say...	「簡単に言ってくれるわね……」
「You'd better not make me do that again.」	「もう一度やれって言われてもお断りよ」	You'd better not make me do that again.	「もう一度やれって言われてもお断りよ」
「Ah, well...」	「あら、そう……」	Ah, well...	「ああ、ええと……」
「Do you at least feel prepared enough to recite a poem in front of other people?」	「最低限、他の人の前で朗読する心の準備はできたのかしら？」	Do you at least feel prepared enough to recite a poem in front of other people?	「最低限、人の前で朗読する心の準備はできたのかしら？」
「I mean, doing it in front of other people will be way easier!」	「他の人の前で朗読するほうがよっぽど楽よ」	I mean, doing it in front of other people will be way easier!	「知らない人の前で朗読するほうがよっぽど楽よ！」
「I can put on whatever face I want for other people.」	「他人の前ならどんな顔してもいいんだから」	I can put on whatever face I want for other people.	「他人の前ならどんな顔してもいいんだから」
「But when it's just my friends...」	「でも友達の前だと……」	But when it's just my friends...	「でも友達の前だと……」
「It's just...embarrassing.」	「……恥ずかしいじゃない」	It's just...embarrassing.	「……恥ずかしいじゃない」
「That's a surprise, Natsuki...」	「意外だね、ナツキちゃん……」	That's a surprise, Natsuki...	「意外だね、ナツキちゃん……」
「I think it would be the other way around for me.」	「わたしの場合、むしろ逆だけどな……」	I think it would be the other way around for me.	「わたしの場合、むしろ逆だけどな……」
「Well, that's just how it is, so...」	「でも、そういうものなんだから……」	Well, that's just how it is, so...	「でも、そういうものなんだから……」
「Well, I guess in that case...」	「まあ、そういうことなら……」	Well, I guess in that case...	「まあ、そういうことなら……」
「You won't have much to worry about for the festival.」	「文化祭については心配いらないわね」	You won't have much to worry about for the festival.	「文化祭については心配いらないわね」
「That said, I want to thank everyone for coming through.」	「それはともかくみんな、やってみてくれてありがとう」	That said, I want to thank everyone for coming through.	「ともかくみんな、やってみてくれてありがとう」
「It might be hard, but I hope that you all have an idea of what it's like now.」	「難しいかもしれないけど、どういうことをするのか分かってもらえたかしら」	It might be hard, but I hope that you all have an idea of what it's like now.	「難しいかもしれないけど、どういうことをするのかわかってもらえたかしら」
「Make sure you pick a poem and get enough practice before the festival, okay?」	「文化祭までに詩を選んで十分に練習をしておくのを忘れないでね？」	Make sure you pick a poem and get enough practice before the festival, okay?	「文化祭までに詩を選んで、十分に練習しておくのを忘れないでね？」
「I'll be making pamphlets, so let me know ahead of time what you'll be reciting.」	「私が詩を載せたパンフレットを作るから、読む詩を私に教えてね」	I'll be making pamphlets, so let me know ahead of time what you'll be reciting.	「私が詩を載せたパンフレットを作るから、読む詩を前もって私に教えてね」
「Jeez...」	「うーん……」	Jeez...	「はあ……」
「I should probably find some other poem to recite instead.」	「俺も朗読のために別の詩を考えておくべきかもな……」	I should probably find some other poem to recite instead.	「俺も朗読のために別の詩を考えておくべきかもな……」
「That's fine, too!」	「それもいいわね！」	That's fine, too!	「それもいいわね！」
「It doesn't have to be your own.」	「別に自分が書いた詩でなくてもいいしね」	It doesn't have to be your own.	「別に自分が書いた詩でなくてもいいしね」
「I'm already pleasantly surprised that you're putting in all this effort for the club.」	「そこまで真剣に部活のことを考えてくれているなんて、少し驚いちゃった」	I'm already pleasantly surprised that you're putting in all this effort for the club.	「そこまで真剣に部活のことを考えてくれているなんて、少し驚いちゃった」
「It makes me really happy.」	「本当に嬉しく思うわ」	It makes me really happy.	「本当にうれしく思うわ」
「Ah... Yeah, no problem...」	「ああ……いや……どういたしまして……」	Ah... Yeah, no problem...	「ああ……いや……どういたしまして……」
「Okay, everyone!」	「よし、みんな！」	Okay, everyone!	「よし、みんな！」
「I think that's about it for today.」	「今日はこれで終わりかしらね」	I think that's about it for today.	「今日はこれで終わりかしらね」
「I know the festival is coming up, but let's try to write poems for tomorrow, as well.」	「文化祭が近づいてはいるけど、明日も頑張って詩を書いてきましょう」	I know the festival is coming up, but let's try to write poems for tomorrow, as well.	「文化祭が近づいてはいるけど、明日もがんばって詩を書いてきましょう」
「It's been working out really nicely so far, so I'd like to continue that.」	「今のところうまくいっているみたいだから、続けていきたいの」	It's been working out really nicely so far, so I'd like to continue that.	「今のところうまくいっているみたいだから、続けていきたいの」
「As for the festival, we'll finish planning tomorrow, and then we'll have the weekend to prepare.」	「文化祭のことは明日計画を全て立てて、週末に準備をするようにしましょう」	As for the festival, we'll finish planning tomorrow, and then we'll have the weekend to prepare.	「文化祭のことは明日計画をしっかり立てて、週末に準備をするようにしましょう」
「Monday's the big day!」	「月曜日は大事な日だからね！」	Monday's the big day!	「本番は、月曜日だからね！」
「I can't wait~!」	「楽しみ～！」	I can't wait~!	「楽しみ～！」
「I can do this... I can do this...」	「私はできる……私はできる……」	I can do this... I can do this...	「私はできる……私はできる……」
「Alright--」	「よし……」	Alright--	「よし……」
I stand up.	俺は立ち上がる。	I stand up.	俺は立ち上がる。
There's no way I'll be able to find the same enthusiasm as Sayori and Monika, but I'll do my best to get through it.	サヨリやモニカほど情熱に満ち溢れているわけではないが、やれるだけのことはやってみようと思う。	There's no way I'll be able to find the same enthusiasm as Sayori and Monika, but I'll do my best to get through it.	サヨリやモニカほど情熱に満ち溢れているわけではないが、やれるだけのことはやってみようと思う。
If it's for the sake of the club...	それがこの部活のためなら……	If it's for the sake of the club...	それがこの部活のためなら……
And impressing Monika...	あとモニカにいいところを見せられるなら……	And impressing Monika...	あとモニカにいいところを見せられるなら……
Then I'll have to do my best.	ベストを尽くそうじゃないか。	Then I'll have to do my best.	ベストを尽くそうじゃないか。
「Ready to go, Sayori?」	「帰る準備できたか、サヨリ？」	Ready to go, Sayori?	「帰る準備できたか、サヨリ？」
「Yep!」	「うん！」	Yep!	「うん！」
「Look at you two, always going home together like that.」	「お二人さん、いつも一緒に帰ってるわね」	Look at you two, always going home together like that.	「お二人さん、いつも一緒に帰ってるわね」
「It's kind of adorable, isn't it?」	「なんだかちょっとかわいいわよね？」	It's kind of adorable, isn't it?	「何だかちょっとかわいいわよね？」
「Ehehe~」	「えへへ～」	Ehehe~	「うふふ」
「Jeez, guys...」	「おいおい……」	Jeez, guys...	「おいおい……」
「Don't make such a big deal out of it.」	「そんな大げさに捉えないでくれ」	Don't make such a big deal out of it.	「そんな大げさに捉えないでくれ」
「It must be a little nice, though...」	「でも、なんだか楽しそう……」	It must be a little nice, though...	「でも、なんだか楽しそう……」
「Well...」	「まあ……」	Well...	「今度は……」
「Ah...」	「その……」	Ah...	「なるほど……」
How am I supposed to respond to that?	一体どういう反応をすればいいんだ？	How am I supposed to respond to that?	一体どういう反応をすればいいんだ？
「It's okay, [player], you don't have to say it.」	「いいんだよ、[player]。何も言わなくても」	It's okay, [player], you don't have to say it.	「いいんだよ、[player]。何も言わなくても」
「...Whatever. Let's go already.」	「……まあいいや。行こうぜ」	...Whatever. Let's go already.	「……まあいいや。行こうぜ」
I walk home with Sayori once more.	また今日もサヨリと下校する。	I walk home with Sayori once more.	また今日もサヨリと下校する。
Even though it's only been a few days, a lot of things have already changed.	入部してからまだ数日しか経っていないが、既にたくさんの変化が起きている。	Even though it's only been a few days, a lot of things have already changed.	入部してからまだ数日しか経っていないが、すでにたくさんの変化が起きている。
But today, Sayori is being a little quieter than usual on the way home.	今日の帰り道でのサヨリは、何だかいつもより静かだ。	But today, Sayori is being a little quieter than usual on the way home.	だが今日の帰り道でのサヨリは、何だかいつもより静かだ。
「Hey, Sayori...」	「なあ、サヨリ……」	Hey, Sayori...	「なあ、サヨリ……」
「...」	「……」	...	「……」
「...Sorry! I was spacing out!」	「……ごめん！ ぼーっとしてた！」	...Sorry! I was spacing out!	「……ごめん！ ぼーっとしてた！」
「Ah, no wonder...」	「ああ、そうらしいな……」	Ah, no wonder...	「ああ、そうらしいな……」
「Um...」	「えっと……」	Um...	「その……」
「I was...thinking about something from earlier.」	「さっきのことを……考えてたの」	I was...thinking about something from earlier.	「さっきのことを……考えてたの」
「I like how we get to...」	「わたしはこうすること好きだけど……」	I like how we get to...	「わたしはこうすること好きだけど……」
「I-I mean...」	「あ、いや、その……」	I-I mean...	「い、いや、その……」
Sayori fumbles with her words.	サヨリは言葉を見つけ出すのに苦労している。	Sayori fumbles with her words.	サヨリは言葉を見つけ出すのに苦労している。
「So...let's just say that one day, [ch2_winner] asked to walk home with you...」	「その……いつか[ch2_winner!t]ちゃんが[player]と一緒に帰りたいって言ったら……」	So...let's just say that one day, [ch2_winner] asked to walk home with you...	「その……いつか[ch2_winner]ちゃんが[player]と一緒に帰りたいって言ったら……」
「Huh?!」	「は！？」	Huh?!	「は！？」
「What would you do?」	「どうする？」	What would you do?	「どうする？」
「What kind of question is that...?」	「なんだその質問は……」	What kind of question is that...?	「何だ、その質問は……」
「You're kind of putting me on the spot here...」	「そんなこと急に聞かれてもな……」	You're kind of putting me on the spot here...	「そんなこと急に聞かれてもな……」
「Ehehe...」	「えへへ……」	Ehehe...	「えへへ……」
Well...	そうだな……	Well...	「その、つまり……」
I would walk home with [ch2_winner].	[ch2_winner!t]と一緒に帰る。	I would walk home with [ch2_winner].	[ch2_winner]と一緒に帰る。
I would still walk home with Sayori.	それでもサヨリと一緒に帰る。	I would still walk home with Sayori.	それでもサヨリと一緒に帰る。
Then again, the festival is only a few days away...	文化祭まではあと数日。	Then again, the festival is only a few days away...	文化祭まではあと数日。
Who knows what will happen in that time?	それまでに何が起こるかは誰にもわからない。	Who knows what will happen in that time?	それまでに何が起こるかは誰にもわからない。
