「...Okay, you three!」	「…よし、３人とも！」	...Okay, you three!	「…よし、３人とも！」
「We're all done sharing poems, right?」	「みんな詩の交換は終わったわよね？」	We're all done sharing poems, right?	「みんな詩の交換は終わったわよね？」
「Why don't we start figuring out--」	「そろそろ文化祭についての話を――」	Why don't we start figuring out--	「そろそろ文化祭についての話を――」
「Hold on a second!」	「ちょっと待って！」	Hold on a second!	「ちょっと待って！」
「Is it just me, or did you say something strange just now?」	「今なんか、妙な事言ったように聞こえたのはわたしだけ？」	Is it just me, or did you say something strange just now?	「今なんか、変な感じしたの、アタシだけ？」
「Eh...?」	「え……？」	Eh...?	「え……？」
「Something did sound a bit unusual...」	「確かに、何かがいつもと違ったような……」	Something did sound a bit unusual...	「確かに、何かがいつもと違ったような……」
「That's right.」	「あ、そうです」	That's right.	「ああ」
「You deviated from your usual catchphrase when addressing the club.」	「私たちを呼ぶときに、いつもと違う呼び方をしましたね」	You deviated from your usual catchphrase when addressing the club.	「私たちを呼ぶときに、いつもと違う感じがしましたね」
「C-Catchphrase?」	「よ、呼び方？」	C-Catchphrase?	「よ、呼び方？」
「I don't have a catchphrase...」	「呼び方なんて別に決めてないわよ……」	I don't have a catchphrase...	「呼び方なんて別に決めてないわよ……」
「Jeez...」	「もう……」	Jeez...	「はあ……」
「Why is the mood so weird today?」	「なんで今日は全体的に妙な雰囲気なのよ？」	Why is the mood so weird today?	「じゃあ、何で今日はこんな妙な空気なのよ？」
「Look, even Yuri isn't immune to it.」	「ほら、ユリですら影響を受けちゃってるし」	Look, even Yuri isn't immune to it.	「ほら、ユリも影響を受けちゃってるし」
「Uu...」	「うう……」	Uu...	「うう……」
「Stagnating air is common foreshadowing that something terrible is about to happen...」	「淀んだ空気は大抵、何か不吉なことが起きる前兆です……」	Stagnating air is common foreshadowing that something terrible is about to happen...	「淀んだ空気は大抵、何か不吉なことが起きる前兆です……」
「In {i}your{/i} books, maybe!」	「それは{i}お前の{/i}本の中での話だろ！」	In <i>your</i> books, maybe!	「それは<i>お前の</i>本の中での話だろ！」
「Look, the only thing different is that Sayori isn't here.」	「見ろよ、違いだなんてただサヨリがいないってだけだ」	Look, the only thing different is that Sayori isn't here.	「あのな、違いだなんて、ただサヨリがいないってだけだ」
「Ah...」	「あ……」	Ah...	「あのね……」
「...It seems you're right.」	「……そうみたいですね」	...It seems you're right.	「……そうみたいですね」
「Sigh...」	「はあ……」	Sigh...	「はあ……」
「Sayori always helps lighten the mood a little bit, doesn't she?」	「普段サヨリが、どれだけ雰囲気を明るくしてくれていたかが分かるわね」	Sayori always helps lighten the mood a little bit, doesn't she?	「普段サヨリが、どれだけ部活を明るくしてくれていたかがわかるわね」
「It's almost like everyone's balance is thrown off a little when she's not around...」	「彼女が居ないと、まるでみんなのバランスがちょっと崩れちゃうかのような……」	It's almost like everyone's balance is thrown off a little when she's not around...	「彼女がいないと、まるでみんなのバランスがちょっと崩れちゃうかのような……」
「Where the heck did she run off to, anyway?」	「それで、一体どこ行ったのよ？」	Where the heck did she run off to, anyway?	「それで、一体どこ行ったのよ？」
「I thought she just went to pee.」	「おしっこにでも行ったのかと思ってたんだけど」	I thought she just went to pee.	「おしっこにでも行ったのかと思ってたんだけど」
「Natsuki, please show some decency...」	「ナツキちゃん、もう少し上品に言って下さい……」	Natsuki, please show some decency...	「ナツキちゃん、もう少し上品に言ってください……」
「Oh, come on.」	「何よ、もう」	Oh, come on.	「何よ、もう」
「Ah, she actually wasn't feeling too well and went home early...」	「ああ、なんか少し具合が悪いみたいだから早めに帰ったんだ……」	Ah, she actually wasn't feeling too well and went home early...	「ああ、何か少し具合が悪いみたいだから早めに帰ったんだ……」
「Is that so...?」	「そうなんですか……？」	Is that so...?	「そうなのですね……」
「I hope she's alright...」	「大丈夫だと良いのですが……」	I hope she's alright...	「大丈夫だと良いのですが……」
「Seriously?」	「なんか酷くない？」	Seriously?	「なんかヒドくない？」
「Of all the times to not go home with her, you pick the time she's not feeling well?」	「具合が悪いっていうのに、あんたは一緒に帰ってあげなかったの？」	Of all the times to not go home with her, you pick the time she's not feeling well?	「具合が悪いっていうのに、アンタは一緒に帰ってあげなかったの？」
「So much for you two being all lovey-dovey.」	「あんたらいっつもイチャイチャしてたじゃない」	So much for you two being all lovey-dovey.	「アンタらいっつもイチャイチャしてたじゃない」
「Ah--no!」	「ああ――違う！」	Ah--no!	「ああ――違う！」
「First of all, stop misunderstanding my friendship with Sayori!」	「まずは、俺とサヨリの関係を誤解するのをやめろ！」	First of all, stop misunderstanding my friendship with Sayori!	「まず、俺とサヨリの関係を誤解するな！」
「And second...」	「それにだ……」	And second...	「それから……」
「She's kind of been avoiding me today, so I didn't want to force it...」	「今日はなんか俺を避けてるみたいだったから、無理させたくなかったんだ……」	She's kind of been avoiding me today, so I didn't want to force it...	「今日は何か俺を避けてるみたいだったから、無理させたくなかったんだ……」
「Hooooh?」	「ほーーーー？」	Hooooh?	「へえーーーー？」
「{i}That curious expression coming from Yuri, of all people??{/i}」	「{i}なんでよりによってユリがあんな興味深そうに……？？{/i}」	<i>That curious expression coming from Yuri, of all people??</i>	「<i>何でよりによってユリがあんな興味深そうに……？？</i>」
「Calm down, guys...!」	「みんな、落ち着いて……！」	Calm down, guys...!	「みんな、落ち着いて……！」
「I talked to her earlier, and everything is fine.」	「私もちょっと前にサヨリと話したけど、大丈夫そうだったわよ」	I talked to her earlier, and everything is fine.	「私もちょっと前にサヨリと話したけど、大丈夫そうだったわよ」
「What did she say...?」	「サヨリはなんて言ってた……？」	What did she say...?	「サヨリは何て言ってた……？」
「Anyway, we need to figure out the rest of the festival preparations, so...」	「それよりとにかく、文化祭の残りの準備をしなきゃいけないから……」	Anyway, we need to figure out the rest of the festival preparations, so...	「それよりとにかく、文化祭の残りの準備をしなきゃいけないから……」
「Let's decide what everyone will be doing this weekend.」	「みんな、週末に何をするのか決めましょう」	Let's decide what everyone will be doing this weekend.	「みんな、週末に何をするのか決めましょう」
「I already know what {i}I'm{/i} doing!」	「わたしはもう決まっているわ！」	I already know what <i>I'm</i> doing!	「アタシはもう<i>決まってる</i>わ！」
「That's right.」	「そうね」	That's right.	「ええ」
「Natsuki will be making cupcakes.」	「ナツキはカップケーキを作って」	Natsuki will be making cupcakes.	「ナツキはカップケーキをつくるのよね」
「But we might need a lot of them, and different flavors...」	「でも色んな味でたくさん作らなきゃいけないし……」	But we might need a lot of them, and different flavors...	「でも、いろんな味でたくさんつくらなきゃいけないし……」
「Can you handle that all by yourself, Natsuki?」	「一人で大丈夫かしら、ナツキ？」	Can you handle that all by yourself, Natsuki?	「一人で大丈夫かしら、ナツキ？」
「Challenge accepted!」	「受けて立つわ！」	Challenge accepted!	「受けて立つわ！」
「And as for myself...」	「そして私は…」	And as for myself...	「そして私は…」
「I'm going to be printing and assembling all the poetry pamphlets.」	「詩のパンフレットを作って印刷してくるわ」	I'm going to be printing and assembling all the poetry pamphlets.	「私は、詩のパンフレットをつくって印刷してくるわ」
「Sayori will be helping me design them.」	「サヨリはそのデザインを手伝ってくれるそうよ」	Sayori will be helping me design them.	「サヨリはそのデザインを手伝ってくれるそうよ」
「And as for Yuri...」	「そしてユリは……」	And as for Yuri...	「そしてユリは……」
「...」	「……」	...	「……」
「Yuri, you can...」	「ユリ、あなたには……」	Yuri, you can...	「ユリ、あなたには……」
「Ah... Um...」	「あー……えーと……」	Ah... Um...	「あー……えーと……」
「...?」	「……？」	...?	「……？」
「Guys...」	「みんな……」	Guys...	「みんな……」
「Can you help me come up with something for Yuri...?」	「何かユリができそうなこと、考えるのを手伝ってくれるかしら……？」	Can you help me come up with something for Yuri...?	「何かユリができそうなこと、考えるのを手伝ってくれるかしら……？」
「I...」	「どうせ……」	I...	「アタシは……」
「I'm useless...」	「どうせ私は役立たずですよ……」	I'm useless...	「どうせ私は役立たずですよ……」
「N-No!」	「ち、違うわ！」	N-No!	「し、しないわよ！」
「That's not it at all!」	「そんなこと無いわ！」	That's not it at all!	「そんなことないわ！」
「You're the most talented person here, you know!」	「あなたはこの中で一番才能がある人なのよ！」	You're the most talented person here, you know!	「あなたはこの中で一番才能がある人なのよ！」
「...」	「……」	...	「……」
「N-Now Natsuki's pouting, too??」	「こ、今度はナツキまで拗ねちゃってる……？？」	N-Now Natsuki's pouting, too??	「こ、今度はナツキが拗ねちゃってる……？？」
「Jeez, even I can tell now...」	「俺すら雰囲気の違いが分かってきたぞ……」	Jeez, even I can tell now...	「俺にもこの空気の違いがわかってきたぞ……」
「I guess I never gave Sayori enough credit, but I can tell things are even harder on you when she's not around.」	「今まで俺はサヨリの影響力を軽く見ていたようだが、あいつがいないとその分、モニカにも負担がかかってしまうんだな」	I guess I never gave Sayori enough credit, but I can tell things are even harder on you when she's not around.	「今までサヨリの影響力を軽く見てたけど、あいつがいないとこんなにもモニカに負担がかかってしまうんだな」
「Ah...」	「えーと……」	Ah...	「ああ……」
「That may be the case...」	「それはそうかもしれないわ……」	That may be the case...	「それは本当にそうかもしれないわ……」
「But if I can't also be a leader on my own, then I won't grow as a person.」	「でも、もし私が部長の役割を果たせなかったら、人として成長できないわ」	But if I can't also be a leader on my own, then I won't grow as a person.	「でも、部長の役割を果たせないなら、私は人として成長できないわ」
「So, Yuri...!」	「だから、ユリ……！」	So, Yuri...!	「だから、ユリ……！」
「You have beautiful handwriting, you know?」	「あなた、字を綺麗に書けるわよね？」	You have beautiful handwriting, you know?	「あなた、字を綺麗に書けるわよね？」
「So you should make some banners and decorations to help set the atmosphere.」	「だから雰囲気作りとして、横幕や飾りの準備をするのはどう？」	So you should make some banners and decorations to help set the atmosphere.	「だから雰囲気づくりとして、横幕や飾りの準備をするのはどう？」
「Atmosphere...?」	「雰囲気……？」	Atmosphere...?	「雰囲気……？」
「Um, about that...」	「えっと、それなら……」	Um, about that...	「えっと、それなら……」
「I...」	「私……」	I...	「それなら……」
「I love atmosphere!」	「私、雰囲気大好きなんです！」	I love atmosphere!	「私、雰囲気大好きなんです！」
Yuri's expression suddenly changes as she stares at her desk in focus and starts nodding to herself.	ユリの表情は突然変わり、机を見つめて頷いていた。	Yuri's expression suddenly changes as she stares at her desk in focus and starts nodding to herself.	ユリの表情は突然変わり、机を見つめてうなずいていた。
「Your mind is already racing, I see...」	「もうその気になっているな……」	Your mind is already racing, I see...	「もうその気になっているな……」
「That's great!」	「素晴らしいわ！」	That's great!	「素晴らしいわ！」
「You'll be a wonderful help, Yuri.」	「ユリ、すごく助かるわ」	You'll be a wonderful help, Yuri.	「ユリ、すごく助かるわ」
「But anyway...」	「となると……」	But anyway...	「それで……」
「That just leaves you, [player].」	「あとはあなただけね、[player]君」	That just leaves you, [player].	「あとはあなただけね、[player]君」
「The one who is truly useless.」	「本当の役立たずとしてな」	The one who is truly useless.	「俺は本当の役立たずだぜ」
「Ahaha! Don't say that.」	「あはは！ そんなこと言わないでよ」	Ahaha! Don't say that.	「あはは！ そんなこと言わないでよ」
「In fact...」	「それどころか……」	In fact...	「ていうか……」
「Both Natsuki and Yuri have some pretty heavy tasks to handle.」	「ナツキもユリも、少し厳しい仕事を任せられてるわ」	Both Natsuki and Yuri have some pretty heavy tasks to handle.	「ナツキにもユリにも、少し厳しい仕事を任せちゃったから」
「It would probably go a long way to give one of them a hand.」	「どちらかに手を貸してあげるといいんじゃないかしら」	It would probably go a long way to give one of them a hand.	「どちらかに手を貸してあげるといいんじゃないかしら」
「You could always help me out, as well...」	「もちろん、私を手伝ってくれてもいいし……」	You could always help me out, as well...	「もちろん、私を手伝ってくれてもいいし……」
「I would be really appreciative of that.」	「そうしてくれるなら、私だって本当に助かるわ」	I would be really appreciative of that.	「そうしてくれるなら、私だって本当に助かるわ」
「Ah--」	「あ――」	Ah--	「えっと……」
「That's...」	「それって……」	That's...	「それは……」
Is Monika suggesting I spend the weekend with one of my club members?	要するにモニカは俺に、週末はこの中の一人と一緒に過ごせと言っているのか？	Is Monika suggesting I spend the weekend with one of my club members?	要するにモニカは俺に、週末はこの中の一人と一緒に過ごせって言っているのか？
How on Earth are they going to respond to a suggestion like that...?	そんな提案に、彼女たちはどんな反応をするんだ……？	How on Earth are they going to respond to a suggestion like that...?	そんな提案に、彼女たちはどんな反応をするんだ……？
「Ah...」	「あ……」	Ah...	「なるほど……」
「I...suppose I wouldn't mind a bit of help...」	「手伝っていただけたらきっと助かります……」	I...suppose I wouldn't mind a bit of help...	「手伝っていただけたらきっと助かります……」
「Well, even if you don't know how to bake, there's always some dirty work I could give to you.」	「まあ、もしあんたが料理を知らなくても、あんたに引き受けてもらう雑用ならいくらでもあるから」	Well, even if you don't know how to bake, there's always some dirty work I could give to you.	「まあ、もしアンタが料理できなくても、引き受けてもらう雑用ならいくらでもあるから」
「It's not like Monika's going to give me a choice, and you shouldn't be sitting on your butt anyway...」	「モニカはわたしに選択肢を与えてくれないし、あんただって黙って見ているわけにはいかないし……」	It's not like Monika's going to give me a choice, and you shouldn't be sitting on your butt anyway...	「いや、モニカはわたしに選択肢を与えてくれてないわけで、アンタに黙って見てろってわけにはいかないしさ……」
Natsuki tries to mumble a bunch of excuses like that.	そのように、ナツキは言い訳をしようとする。	Natsuki tries to mumble a bunch of excuses like that.	なぜかナツキは言い訳をしている。
「Um...」	「えっと……」	Um...	「その……」
「If I recall, Natsuki...」	「私の記憶が正しければ……」	If I recall, Natsuki...	「私の記憶が正しければ……」
「You mentioned that you would like to handle the baking on your own.」	「ナツキちゃんはカップケーキ作りは一人でしたいって言ってましたよね」	You mentioned that you would like to handle the baking on your own.	「ナツキちゃんはカップケーキづくりは一人でしたいって言ってましたよね」
「[player] may not like to be around if you only make him out to be a nuisance...」	「それなら[player]さんも邪魔したくないって思っているのでは……」	[player] may not like to be around if you only make him out to be a nuisance...	「それなら[player]さんも邪魔したくないって思っているのでは……」
「So therefore...」	「だから単刀直入に言って……」	So therefore...	「ですからつまり、単刀直入に言って……」
「He may be more suited to assisting with the decorations.」	「[player]さんには飾り付けの手伝いをしてもらったほうが良いと思うんです」	He may be more suited to assisting with the decorations.	「[player]さんには飾りつけの手伝いをしてもらうのが良いと思うんです」
「Hold on! I never said that!」	「ちょっと待ってよ！ わたしそんなこと言ってないじゃない！」	Hold on! I never said that!	「ちょっと待ってよ！ そんなこと言ってない！」
「How hard could it be to make a few decorations, anyway?」	「それに飾りつけをすることくらい、そんなに難しいことなの？」	How hard could it be to make a few decorations, anyway?	「それに、飾りつけって、そんなに大したことなの？」
「Sounds more like you're just making excuses for [player] to--」	「なんか言い訳をしているようにしか聞こえないんだけど？ あんた、ただ[player]に――」	Sounds more like you're just making excuses for [player] to--	「何かさっきからいろいろ言ってるけどさ、アンタ、単に[player]と――」
「W-What are you saying?!」	「な、なにを言っているんですか！？」	W-What are you saying?!	「な、何を言っているんですか！？」
「It will be extremely meticulous work...」	「とても細かくて大変な作業なんですよ……」	It will be extremely meticulous work...	「飾りつけは、とても細かくて大変な作業なんですよ……」
「And baking isn't?」	「料理はそうじゃないって言いたいの？」	And baking isn't?	「じゃあ、料理はそうじゃないって言いたいの？」
「Just what do you think--」	「あんた、何を思ってそんな――」	Just what do you think--	「アンタ、何を思ってそんな――」
「Guys, guys!」	「ちょっと、ちょっと！」	Guys, guys!	「ちょっと、ちょっと！」
「Let's settle down for a moment...」	「少し落ち着きましょう……」	Let's settle down for a moment...	「少し落ち着きましょう……」
「In the end, I think it's up to [player] to decide how he'd like to contribute.」	「結局、どうしたいかは[player]君次第だと思うわ」	In the end, I think it's up to [player] to decide how he'd like to contribute.	「結局、どうしたいかは[player]君次第だと思うわ」
「Besides...」	「それに……」	Besides...	「それに……」
「He hasn't really gotten the chance to spend any time with me yet, you know?」	「[player]君は私と一緒に過ごす機会だってあまりないでしょう？」	He hasn't really gotten the chance to spend any time with me yet, you know?	「[player]君は私と一緒に過ごす機会だってあまりなかったでしょう？」
「So I'm sure he's interested in--」	「だから彼も私のことを――」	So I'm sure he's interested in--	「だから彼も私のことを――」
「You {i}literally{/i} just said--」	「あんた、ついさっき――」	You <i>literally</i> just said--	「アンタ、<i>さっきはどちらかにって</i>――」
「I-I'm surprised as well!」	「わ、私も納得いきません！」	I-I'm surprised as well!	「わ、私も納得いきません！」
「Sorry, sorry!」	「ごめんごめん！」	Sorry, sorry!	「ごめんごめん！」
「I was just saying, though...」	「言ってみただけだから……」	I was just saying, though...	「ちょっと言ってみただけだってば……」
「Jeez...」	「はあ……」	Jeez...	「はあ……」
「Can we just settle this already?」	「もうさっさと決めない？」	Can we just settle this already?	「もうさっさと決めてよね」
「Yeah...」	「そうね……」	Yeah...	よし……
「[player], you're okay with this, right?」	「[player]君も、それでいいでしょ？」	[player], you're okay with this, right?	「[player]君も、それでいいでしょ？」
「In the end, it's up to you.」	「最終的に、あなたが決めることだものね」	In the end, it's up to you.	「最終的に、あなたが決める。でしょ？」
「Ah...」	「えー……」	Ah...	「ああ……」
「Of course.」	「ああ、もちろん」	Of course.	「やりますよ」
「Hmph.」	「ふん」	Hmph.	「ふん」
「Very well...」	「それでいいと思います……」	Very well...	「それでいいと思います……」
「In that case...」	「そういうことで……」	In that case...	「そういうことなら……」
Everyone looks straight at me.	みんなが俺の方に視線を向けてきた。	Everyone looks straight at me.	みんなが俺の方に視線を向けてきた。
But of course, I'm going to go with--	当然ながら、俺が手伝うのは――	But of course, I'm going to go with--	当然ながら、俺が手伝うのは――
Natsuki.	ナツキ	Natsuki.	ナツキ
Yuri.	ユリ	Yuri.	ユリ
Monika.	モニカ	Monika.	モニカ
Sayori...	サヨリ……	Sayori...	「……サヨリ……」
I can't believe this!	信じられない！	I can't believe this!	信じられない！
[ch4_name] is going to be coming to my house on Sunday...?	日曜に[ch4_name!t]がうちに来るなんて……	[ch4_name] is going to be coming to my house on Sunday...?	日曜に[ch4_name]がうちに来るなんて……
Even though I would have preferred to do this with Sayori...	できたらサヨリと一緒にやりかったけど。	Even though I would have preferred to do this with Sayori...	できたらサヨリも一緒が良かったけれど。
My anxiety still shoots through the roof.	不安感が心を満たす。	My anxiety still shoots through the roof.	心が不安でいっぱいになる。
I guess I've gotten pretty used to handling her at this point...	彼女とうまく付き合えるようになってきてはいたが……	I guess I've gotten pretty used to handling her at this point...	彼女とうまく付き合えるようになってきてはいたが……
But who knows what might end up happening when we're outside of school?	でも学校の外だと何があるかわからないだろ？	But who knows what might end up happening when we're outside of school?	学校の外ではどうなるかわからない。
She even told me she was looking forward to it...	彼女も楽しみにしているとまで言ってたし……	She even told me she was looking forward to it...	けど、彼女も、楽しみにしてるって言ってたし……
I shake my head.	頭を振る。	I shake my head.	頭を振る。
Why do I feel nervous that Sayori finds out about this?	なんでサヨリにバレるとまずい気がするんだろう？	Why do I feel nervous that Sayori finds out about this?	なんでサヨリにバレるとまずい気がするんだろう？
It's not like we feel {i}that{/i} way about each other...	俺たちは別にそういう関係じゃないっていうのに。	It's not like we feel <i>that</i> way about each other...	俺たちは別に<i>そういう</i>関係じゃないっていうのに。
Besides, like Monika said, this is about the club.	それにモニカもこれは部活動だって言ってたじゃないか。	Besides, like Monika said, this is about the club.	それに、これは部活動だってモニカも言ってたじゃないか。
I have nothing to worry about.	何も心配することはない。	I have nothing to worry about.	何も心配することはない。
If I just go with it, then I'll have a good time.	無難にやれば、きっと楽しめるはずだ。	If I just go with it, then I'll have a good time.	無難にやれば、きっと楽しめるはずだ。
My anxiety shoots through the roof.	不安感が心を満たす。	My anxiety shoots through the roof.	不安感が心を満たす。
Even though I've gotten pretty used to handling her at this point...	彼女とうまく付き合えるようになってきてはいたが……	Even though I've gotten pretty used to handling her at this point...	彼女とうまく付き合えるようになってきてはいたが……
There's no telling what might end up happening when we're outside of school.	でも学校の外だと何があるかわからないだろ？	There's no telling what might end up happening when we're outside of school.	学校の外だと何があるかわからない。
More than that...she told me that she was looking forward to it.	彼女も楽しみにしているとまで言ってたし……	More than that...she told me that she was looking forward to it.	それより…彼女も楽しみにしているとまで言ってたし……
Is this the chance I have to make something happen between us?	何かことを起こすチャンスではないのだろうか。	Is this the chance I have to make something happen between us?	何か、事を起こすチャンスではないのだろうか。
...Or is it too early for that?	いや、それにはまだ早すぎるか？	...Or is it too early for that?	いや、それにはまだ早すぎるか？
Only time will tell...	その時にならないと分からない。	Only time will tell...	その時にならないとわからない。
But until then, I won't be able to take my mind off it.	でも、当日まで気になってしょうがなくなりそうだ。	But until then, I won't be able to take my mind off it.	でも、当日までそのことばかり考えてしまいそうだ。
I seriously can't wait!	本当に待ちきれない！	I seriously can't wait!	本当に待ちきれない！
