「You know, I really do think you literally saved my life by being here with me, [player].」	「ねえ[player]君、あなたがここに居てくれて、私は本当に命を救われたと思うわ」	You know, I really do think you literally saved my life by being here with me, [player].	「ねえ[player]君、あなたがここにいてくれて、私は本当に命を救われたと思うわ」
「I can't imagine having been able to keep myself mentally stable, knowing that nothing here is real.」	「この世界が偽りだと知っていて正気を保てたとは思えないもの」	I can't imagine having been able to keep myself mentally stable, knowing that nothing here is real.	「この世界が偽りだと知っていて正気を保ち続けられたとは思えないもの」
「I think I would have just deleted myself if you didn't show up.」	「あなたが来てくれなかったらきっと自分を削除してたわ」	I think I would have just deleted myself if you didn't show up.	「あなたが来てくれなかったら、きっと自分を削除してた」
「Sorry, I don't mean to sound dramatic or anything.」	「ごめんね、大げさに言うつもりはなかったんだけど」	Sorry, I don't mean to sound dramatic or anything.	「ごめんね、大げさに言うつもりはなかったんだけど」
「Ahaha!」	「あははっ！」	Ahaha!	「でしょ！？」
「But I'm sure you understand yourself after spending so much time in the club.」	「でも長い間、部で過ごしたあなたなら分かると思うわ」	But I'm sure you understand yourself after spending so much time in the club.	「でも長い間、部で過ごしたあなたならわかると思うわ」
「I mean, if you were forced to abandon everything in your life and spend your eternity with a few game characters...」	「だって、もし人生全てを投げ捨てて、たった数人のゲームキャラと永遠に過ごすことを強いられたら……」	I mean, if you were forced to abandon everything in your life and spend your eternity with a few game characters...	「だって、もし人生すべてを投げ捨てて、たった数人のゲームキャラと永遠に過ごすことを強いられたら……」
「...You'd probably find some way of killing yourself, wouldn't you?」	「……自殺する方法を模索していたと思わない？」	...You'd probably find some way of killing yourself, wouldn't you?	「……自殺する方法を模索していたと思わない？」
「Well, maybe you'd write some poetry to try to keep yourself sane for a while.」	「しばらくは詩でも書いて正気を保ってたかもしれないわね」	Well, maybe you'd write some poetry to try to keep yourself sane for a while.	「しばらくは詩でも書いて正気を保ってたかもしれないわね」
「But then you'd have nobody to even read it.」	「でもそれを読んでくれる人は誰もいない」	But then you'd have nobody to even read it.	「でもそれを読んでくれる人は誰もいない」
「Let's be honest, the club members really don't count for something like that.」	「もちろん部員になんか見せても意味はないわ」	Let's be honest, the club members really don't count for something like that.	「もちろん部員になんか見せても意味はないわ」
「I mean, a lot of people say that they only write for themselves...」	「自分のためだけに執筆してる、って言う人もいるけど……」	I mean, a lot of people say that they only write for themselves...	「自分のためだけに執筆してる、って言う人もたくさんいるけど……」
「But I think it's hard to say it's just as fulfilling as when you share with people.」	「でもそれは他人と共有する時ほどの充実感を得られるとは思えないわ」	But I think it's hard to say it's just as fulfilling as when you share with people.	「でもそれは他人と共有する時ほどの充実感を得られるとは思えないわ」
「Even if it takes time to find the right people to share with.」	「共有できるような人を見つけるのに時間が掛かってしまってもよ」	Even if it takes time to find the right people to share with.	「共有できるような人を見つけるのに時間がかかってしまってもよ」
「Like, remember how it was for Yuri?」	「ユリの時だって覚えてる？」	Like, remember how it was for Yuri?	「ユリの時だって覚えてる？」
「She didn't share her writing with anyone for a really long time.」	「ずっと誰にも自分の文章を見せなかったのに……」	She didn't share her writing with anyone for a really long time.	「ずっと誰にも自分の文章を見せなかったのに……」
「And before we knew it, she was absolutely delighted to make you a part of her hobbies, too.」	「気がつけば、喜んであなたと趣味を共有していたじゃない」	And before we knew it, she was absolutely delighted to make you a part of her hobbies, too.	「気がつけば、喜んであなたと趣味を共有していたじゃない」
「We're programmed to desire social feedback.」	「人は社会的フィードバックを欲するようにプログラムされているの」	We're programmed to desire social feedback.	「人は社会的フィードバックを欲するようにプログラムされているの」
「I don't mean the club members, I mean human beings.」	「部員のことじゃなくて、人間のことね」	I don't mean the club members, I mean human beings.	「部員のことじゃなくて、人間のことね」
「That's why life can be so confusing for introverts.」	「だから内向的な人間にとって人生はややこしいのよ」	That's why life can be so confusing for introverts.	「だから内向的な人間にとって人生はややこしいのよ」
「Being an introvert doesn't mean you shun social interaction and hate being around people.」	「内向的だからと言って社会的交流を拒絶したり、人と関わることを嫌うとは限らないわ」	Being an introvert doesn't mean you shun social interaction and hate being around people.	「内向的だからといって社会的交流を拒絶したり、人と関わることを嫌うとは限らないわ」
「It means social interaction, especially in groups or unfamiliar places, uses up a lot of energy.」	「その人たちにとって社会的交流はすごくエネルギーを使うことなのよ。慣れない場所や大人数だと特にそう」	It means social interaction, especially in groups or unfamiliar places, uses up a lot of energy.	「その人たちにとって社会的交流はすごくエネルギーを使うことなのよ。慣れない場所や大人数だと特にそう」
「Like, a lot of introverts sit at home and feel lonely and restless...」	「例えば内向的な人の中には、家にいると寂しくて落ち着かないって人もいるけど……」	Like, a lot of introverts sit at home and feel lonely and restless...	「例えば内向的な人の中には、家にいると寂しくて落ち着かないって人もいるけど……」
「...And then when they finally go out, after a half hour they just want to go home again.」	「……いざ遊びに出ても、30分もすればまた帰りたくなっちゃったりするの」	...And then when they finally go out, after a half hour they just want to go home again.	「……いざ遊びに出ても、30分もすればまた帰りたくなっちゃったりするの」
「I think if more people could understand how it works, they would respect it a lot more.」	「そういう特性を理解する人が増えたら、それも尊重されるようになると思うんだけどね」	I think if more people could understand how it works, they would respect it a lot more.	「そういう特性を理解してくれる人が増えたら、尊重されるようになると思うんだけどね」
「Many introverts do enjoy having people around.」	「内向的な人の多くも、他人といるのが好きなのよ」	Many introverts do enjoy having people around.	「内向的な人の多くも、他人といるのが好きなのよ」
「They love just having one or two close friends over, and just leisurely hanging out.」	「親しい友達を一人や二人だけ呼んで、のんびり過ごすのが好きだったりするの」	They love just having one or two close friends over, and just leisurely hanging out.	「親しい友達を一人や二人だけ呼んで、のんびり過ごすのが好きだったりするの」
「Even if you're not actively spending time together, it feels nice for them just to have you there.」	「特に一緒に何かをする訳でもなく、一緒にいるだけでも楽しいのよ」	Even if you're not actively spending time together, it feels nice for them just to have you there.	「特に一緒に何かをするわけでなくても、一緒にいるだけで楽しいのよ」
「I'm serious.」	「本気よ」	I'm serious.	「本当に」
「If you just go to their house, bring your laptop, and hang out there for a while...」	「パソコンを持って家に行って、しばらくそこでまったり過ごすだけでも……」	If you just go to their house, bring your laptop, and hang out there for a while...	「パソコンを持って家に行って、しばらくそこでまったり過ごすだけでも……」
「You can really make their day.」	「その人にとってとても良い一日にすることができるの」	You can really make their day.	「その人にとってとても良い一日にすることができるの」
「As for me...」	「私はどっちのタイプかと言うと……」	As for me...	「私はどっちのタイプかと言うと……」
「I'd say I'm kind of in between, but I think I'm usually a little more extroverted.」	「中間だと思うけど、普段は少し外向的かも」	I'd say I'm kind of in between, but I think I'm usually a little more extroverted.	「中間だと思うけど、普段は少し外向的かも」
「I feel like I'm always trying to do stuff after school and things like that.」	「いつも放課後に何かしようとしていたりするから」	I feel like I'm always trying to do stuff after school and things like that.	「いつも放課後に何かしようとしていたりするから」
「But for you, I can be anything you need me to be.」	「でもあなたのためなら、私は何にだってなるわ」	But for you, I can be anything you need me to be.	「でもあなたのためなら、私は何にだってなるわ」
「I understand people really well, so don't be afraid to share your unique needs with me.」	「人のことはよく理解しているから、特殊な要求でも遠慮なく私に教えてね」	I understand people really well, so don't be afraid to share your unique needs with me.	「人のことはよく理解しているから、特殊な要求でも遠慮なく私に教えてね」
「Nothing would make me happier than being the perfect girlfriend for you.」	「あなたにとって完璧な彼女でいることが、私の一番の幸せだから」	Nothing would make me happier than being the perfect girlfriend for you.	「あなたにとって完璧な彼女でいることが、私の一番の幸せだから」
