「Well, I guess I should probably be helping Monika...」	「ええと、じゃあ俺はモニカの手伝いをしようかな……」	Well, I guess I should probably be helping Monika...	「ええと、じゃあ俺はモニカの手伝いをしようかな……」
「Yay, you picked me!」	「やったー！ 私を選んでくれるのね」	Yay, you picked me!	「やった、私を選んでくれるのね！」
「Hold on one second!」	「ちょっと待って！」	Hold on one second!	「ちょっと待って！」
「Y-Yeah!」	「そ、そうです！」	Y-Yeah!	「そ、そうです！」
「Monika, you're the one who needs the least help out of all of us!」	「モニカ、あんたの仕事が一番楽なんじゃない！」	Monika, you're the one who needs the least help out of all of us!	「モニカ、アンタの仕事が一番楽でしょ！」
「Eh? But...」	「え？ でも……」	Eh? But...	「え？ でも……」
「I agree with Natsuki.」	「ナツキちゃんに同意です」	I agree with Natsuki.	「ナツキちゃんに同意です」
「Not only is your work already most suitable for one person...」	「一人でも十分にこなせる仕事ですし……」	Not only is your work already most suitable for one person...	「一人でも十分にこなせる仕事ですし……」
「But you already have Sayori as well.」	「そのうえ既にサヨリちゃんに手伝ってもらっているではないですか」	But you already have Sayori as well.	「そのうえ、すでにサヨリちゃんに手伝ってもらっているではないですか」
「But [player] was the one who...」	「でもそれは[player]君が……」	But [player] was the one who...	「でもそれは[player]君が……」
「Ah...」	「ええと……」	Ah...	「あのね……」
「That doesn't matter.」	「そこは関係ない」	That doesn't matter.	「そんなの関係ない」
「You were the one who scared him into picking you in the first place.」	「そもそもあんたが[player]を怖がらせて自分を選ばせたんでしょ」	You were the one who scared him into picking you in the first place.	「そもそもアンタが[player]を怖がらせて自分を選ばせたんでしょ」
「You're the club president, Monika.」	「自分が部長だって分かってる？ モニカ」	You're the club president, Monika.	「モニカ、アンタ部長なのよ、わかってる？」
「You're supposed to make responsible decisions for the club!」	「部のために責任持って決断してよ！」	You're supposed to make responsible decisions for the club!	「部のために責任持って決断してよ！」
「Monika, you shouldn't let any ulterior motives interfere with this decision.」	「モニカちゃん、下心で決断するのはよくないですよ」	Monika, you shouldn't let any ulterior motives interfere with this decision.	「モニカちゃん、下心で決めるのは良くないですよ」
「Ulterior motives?」	「下心？」	Ulterior motives?	「下心？」
「W-What are you saying, Yuri?」	「な、何言ってるのユリ？」	W-What are you saying, Yuri?	「な、何言ってるのユリ？」
「In fact, it sounds like you guys are the ones with ulterior motives!」	「実際、下心持ってるのは二人でしょ！」	In fact, it sounds like you guys are the ones with ulterior motives!	「実際、下心持ってるのは、二人の方でしょ！」
「<i>Excuse</i> me?」	「<i>なんですって？</i>」	<i>Excuse</i> me?	「<i>何ですって？</i>」
「Otherwise...this wouldn't have been made into such a big deal in the first place!」	「そうじゃなかったら、そもそもこんな大事にはなってないわ！」	Otherwise...this wouldn't have been made into such a big deal in the first place!	「そうじゃなかったら、そもそもこんな大事にはなってないわ！」
「That's...completely false, Monika!」	「それは……違います、モニカちゃん！」	That's...completely false, Monika!	「それは……絶対に違います、モニカちゃん！」
「Yeah!」	「そうよ！」	Yeah!	「いいね！」
「We have a lot of work to do, you know!」	「わたしたちはやることいっぱいあるんだから！」	We have a lot of work to do, you know!	「わたしたちはやることいっぱいあるんだから！」
「We won't do as good of a job if you make us work alone.」	「一人でやっても、うまくいかないわよ」	We won't do as good of a job if you make us work alone.	「一人でやっても、うまくいかないわよ」
「Ah...maybe...that's true...」	「ああ……確かにそうかもね……」	Ah...maybe...that's true...	「まあ……確かにそうかもね……」
「Think of the club, Monika...」	「部のことを考えて下さい、モニカちゃん」	Think of the club, Monika...	「部のことを考えてください、モニカちゃん」
「If we want our event to succeed, then we need to appropriately distribute our resources.」	「出し物を成功させたいのなら、分担はちゃんとしないと」	If we want our event to succeed, then we need to appropriately distribute our resources.	「出し物を成功させたいのなら、分担はちゃんとしないと」
「Um...」	「ううん……」	Um...	「その……」
「Ah...」	「ええと……」	Ah...	「ああ……」
「So are you going to do the right thing, <i>President</i>?」	「それであんたは賢明な判断をしてくれるのかしら、<i>部長さん</i>？」	So are you going to do the right thing, <i>President</i>?	「それでアンタは賢明な判断をしてくれるのかしら、<i>部長さん</i>？」
「Okay, okay!」	「分かった、分かったわ！」	Okay, okay!	「わかった、わかったわ！」
「I get it!」	「分かったわよ！」	I get it!	「わかったわよ！」
「Sigh...」	「はあ……」	Sigh...	「はあ……」
「It's...technically most logical for [player] to help one of you two.」	「[player]君は……二人のどっちかを手伝ったほうが合理的かもね」	It's...technically most logical for [player] to help one of you two.	「[player]君は……二人のどちらかを手伝った方が合理的かもね」
「So...」	「だから……」	So...	「それで……」
「I guess...that's what we'll do.」	「その方向で……行きましょ」	I guess...that's what we'll do.	「その方向で……行きましょ」
「Do you have a preference, [player]?」	「[player]君はどっちがいい？」	Do you have a preference, [player]?	「[player]君はどっちがいい？」
Natsuki.	ナツキ	Natsuki.	ナツキ
Yuri.	ユリ	Yuri.	ユリ
Sayori...	サヨリ……	Sayori...	「……サヨリ……」
