「You know, it's been a while since we've done one of these...」	「そういえば、しばらくアレやってなかったわよね……」	You know, it's been a while since we've done one of these...	「そういえば、しばらくアレやってなかったわよね……」
「...so let's go for it!」	「……ということで！」	...so let's go for it!	「……ということで！」
「Here's Monika's Writing Tip of the Day!」	「本日のモニカちゃんの執筆アドバイス！」	Here's Monika's Writing Tip of the Day!	「本日のモニカちゃんの執筆アドバイス！」
「Sometimes when I talk to people who are impressed by my writing, they say things like 'I could never do that'.」	「私の作品に関心した人から『自分には絶対できない』ってたまに言われることがあるけど……」	Sometimes when I talk to people who are impressed by my writing, they say things like 'I could never do that'.	「私の作品に関心した人から『自分には絶対できない』ってたまに言われることがあるけど……」
「It's really depressing, you know?」	「それって言われてすごく悲しいことなのよ？」	It's really depressing, you know?	「それって言われてすごく悲しいことなのよ？」
「As someone who loves more than anything else to share the joy of exploring your passions...」	「好きなことを追求して共有することが何よりの喜びである人からすれば……」	As someone who loves more than anything else to share the joy of exploring your passions...	「好きなことを追求して共有することが何よりの喜びである人からすれば……」
「...it pains me when people think that being good just comes naturally.」	「……それが自然と身についたものだって思われるのが悲しいの」	...it pains me when people think that being good just comes naturally.	「……それが自然と身についたものだって思われるのが悲しいの」
「That's how it is with everything, not just writing.」	「これは執筆だけじゃなくて何にでも言えることよ」	That's how it is with everything, not just writing.	「これは執筆だけじゃなくて、何にでも言えることよ」
「When you try something for the first time, you're probably going to suck at it.」	「何かに初めて挑戦すると、最初は多分すごく下手くそよ」	When you try something for the first time, you're probably going to suck at it.	「何かに初めて挑戦すると、最初はたぶんすごく下手くそよ」
「Sometimes, when you finish, you feel really proud of it and even want to share it with everyone.」	「それでも何かをやり遂げたら、すごく誇らしげになって、みんなに自慢したくなるかもしれない」	Sometimes, when you finish, you feel really proud of it and even want to share it with everyone.	「それでも何かをやり遂げたら、すごく誇らしくなって、みんなに自慢したくなるかもしれない」
「But maybe after a few weeks you come back to it, and you realize it was never really any good.」	「でも何週間か経ったあとにもう一度見てみたら、思ったほど大したものでもなかったことに気づいてしまうかもしれない」	But maybe after a few weeks you come back to it, and you realize it was never really any good.	「でも何週間か経ったあとにもう一度見てみたら、思ったほど大したものではなかったことに気づいてしまうかもしれない」
「That happens to me all the time.」	「私もいつもそうなるわ」	That happens to me all the time.	「私もいつもそうなるわ」
「It can be pretty disheartening to put so much time and effort into something, and then you realize it sucks.」	「たくさん時間と努力を注いで作ったものが下手だったって気づくと落ち込むもの」	It can be pretty disheartening to put so much time and effort into something, and then you realize it sucks.	「たくさん時間と努力を注いでつくったものが下手だったって気づくと、落ち込むの」
「But that tends to happen when you're always comparing yourself to the top professionals.」	「でもそれはプロレベルと自分を比べてると起こりやすいの」	But that tends to happen when you're always comparing yourself to the top professionals.	「でもそれはプロレベルと自分を比べると起こりやすいのよ」
「When you reach right for the stars, they're always gonna be out of your reach, you know?」	「星を掴もうとしても、ずっと手の届かないところのままでしょ？」	When you reach right for the stars, they're always gonna be out of your reach, you know?	「星をつかもうとしても、ずっと手の届かないところのままでしょ？」
「The truth is, you have to climb up there, step by step.」	「実際は、一歩ずつ一歩ずつ登っていかないといけないの」	The truth is, you have to climb up there, step by step.	「実際は、一歩ずつ一歩ずつ登っていかないといけないの」
「And whenever you reach a milestone, first you look back and see how far you've gotten...」	「そして目標を一つ達成したときにまず振り返ると今までの道のりが見えて……」	And whenever you reach a milestone, first you look back and see how far you've gotten...	「そして目標を一つ達成したときにまず振り返ると、これまでの道のりが見えて……」
「And then you look ahead and realize how much more there is to go.」	「それから前を見るとあとどれだけ登らないといけないかを目の当たりにするの」	And then you look ahead and realize how much more there is to go.	「それから前を見ると、あとどれだけ登らないといけないかを目の当たりにする」
「So, sometimes it can help to set the bar a little lower...」	「だからたまにはハードルを少し低めに設定した方がいいかも……」	So, sometimes it can help to set the bar a little lower...	「だから、たまにはハードルを少し低めに設定した方がいいのかも……」
「Try to find something you think is <i>pretty</i> good, but not world-class.」	「そこそこ良いけど世界レベルじゃないものを探してきて……」	Try to find something you think is <i>pretty</i> good, but not world-class.	「<i>すごく</i>良いけど世界レベルじゃないものを探してきて……」
「And you can make that your own personal goal.」	「それを自分の目標にすればいいの」	And you can make that your own personal goal.	「それを自分の目標にすればいいの」
「It's also really important to understand the scope of what you're trying to do.」	「それと、自分が達成しようとしていることの規模を把握するのも大事よ」	It's also really important to understand the scope of what you're trying to do.	「それと、自分が達成しようとしていることの規模を把握するのも大事よ」
「If you jump right into a huge project and you're still amateur, you'll never get it done.」	「アマチュアなのに突然巨大プロジェクトに飛び込んだら、到底終わらないわ」	If you jump right into a huge project and you're still amateur, you'll never get it done.	「アマチュアなのに突然巨大プロジェクトに飛び込んだら、到底終わらないわ」
「So if we're talking about writing, a novel might be too much at first.」	「執筆で例えるなら、最初から長編小説を書くのは難しいかもしれないから……」	So if we're talking about writing, a novel might be too much at first.	「執筆で例えるなら、最初から長編小説を書くのは難しいかもしれないから……」
「Why not try some short stories?」	「まずは短編から始めてみてはどうかしら？」	Why not try some short stories?	「まずは短編から始めてみてはどうかしら？」
「The great thing about short stories is that you can focus on just one thing that you want to do right.」	「短編の良いところは、自分がそれで達成したいことだけに集中して書けることよ」	The great thing about short stories is that you can focus on just one thing that you want to do right.	「短編の良いところは、自分が達成したいことだけに集中して書けることよ」
「That goes for small projects in general - you can really focus on the one or two things.」	「小さめの課題なら何でもそう……一点や二点だけに集中することができるの」	That goes for small projects in general - you can really focus on the one or two things.	「小さめの課題なら何でもそう……一点や二点だけに集中することができるの」
「It's such a good learning experience and stepping stone.」	「勉強になるし、上達への足掛かりになるわ」	It's such a good learning experience and stepping stone.	「勉強になるし、上達への足掛かりになるわ」
「Oh, one more thing...」	「あっ、あともう一つ……」	Oh, one more thing...	「あっ、あともう一つ……」
「Writing isn't something where you just reach into your heart and something beautiful comes out.」	「執筆することって、心に手を入れて何か美しいものを取り出すことじゃないわ」	Writing isn't something where you just reach into your heart and something beautiful comes out.	「執筆することって、心に手を入れて何か美しいものを取り出すことじゃないわ」
「Just like drawing and painting, it's a skill in itself to learn how to express what you have inside.」	「絵を描くことと一緒で、自分の中にあるものを表現する方法を技能として身につけることなのよ」	Just like drawing and painting, it's a skill in itself to learn how to express what you have inside.	「絵を描くことと一緒で、自分の中にあるものを表現する方法を技能として身につけることなのよ」
「That means there are methods and guides and basics to it!」	「それは基礎、技法、方法論などがあるってことでもあるわ！」	That means there are methods and guides and basics to it!	「つまり、基礎、技法、方法論などがあるってこと！」
「Reading up on that stuff can be super eye-opening.」	「勉強してみると目からうろこだったりするのよ」	Reading up on that stuff can be super eye-opening.	「勉強してみると目からうろこだったりするのよ」
「That sort of planning and organization will really help prevent you from getting overwhelmed and giving up.」	「そういった準備や計画をすることで、途中で参って諦めてしまうことを防げるわ」	That sort of planning and organization will really help prevent you from getting overwhelmed and giving up.	「そういった準備や計画をすることで、途中で参って諦めてしまうことを防げるわ」
「And before you know it...」	「そしてそうやっていくうちに……」	And before you know it...	「そしてそうやっていくうちに……」
「You start sucking less and less.」	「どんどん下手じゃなくなっていくの」	You start sucking less and less.	「どんどん下手じゃなくなっていくの」
「Nothing comes naturally.」	「自然に身に付くことなんてないわ」	Nothing comes naturally.	「自然に身に付くことなんてないわ」
「Our society, our art, everything - it's built on thousands of years of human innovation.」	「私たちの社会、芸術、全ては何千年もの人類の革新の上に成り立ってる」	Our society, our art, everything - it's built on thousands of years of human innovation.	「私たちの社会、芸術、全ては……何千年もの人類の革新の上に成り立ってる」
「So as long as you start on that foundation, and take it step by step...」	「だから同じようにしっかりと土台から始めて、一歩ずつ一歩ずつ進んでいけば……」	So as long as you start on that foundation, and take it step by step...	「だから同じようにしっかりと土台から始めて、一歩ずつ一歩ずつ進んでいけば……」
「You, too, can do amazing things.」	「あなただって、すごいことを成し遂げられる」	You, too, can do amazing things.	「あなただって、すごいことを成し遂げられる」
「...That's my advice for today!」	「……以上、本日のアドバイスでした！」	...That's my advice for today!	「……以上、本日のアドバイスでした！」
「Thanks for listening~」	「ご清聴、ありがとうございました～」	Thanks for listening~	「ご清聴、ありがとうございました～」
