「Yuri--?」	「ユリ……？」	Yuri--?	「ユリ……？」
「Ah...」	「あっ……」	Ah...	「あのね……」
「Thank goodness...」	「良かった……」	Thank goodness...	「良かった……」
「You're a little early...」	「早かったな……」	You're a little early...	「早かったな……」
「I'm sorry I wasn't home yet!」	「留守にしててすまなかった！」	I'm sorry I wasn't home yet!	「留守にしててすまなかった！」
「Were you waiting for a long time?」	「待たせてしまったか？」	Were you waiting for a long time?	「待たせてしまったか？」
「No, I just got here.」	「いいえ、私も着いたばかりです」	No, I just got here.	「いいえ、私も着いたばかりです」
「But I started to get really nervous when nobody answered the doorbell...」	「インターホンを押しても誰も出ないから少し焦りましたけれど……」	But I started to get really nervous when nobody answered the doorbell...	「インターホンを押しても誰も出ないから少し焦りましたけれど……」
「You always could have texted me.」	「メールでも送ってくれればいいのに」	You always could have texted me.	「メールでも送ってくれればいいのに」
「If I had known, I would have reassured you and hurried more on my way home.」	「早めに来るのが分かってたらもっと早く帰ってきてたぞ」	If I had known, I would have reassured you and hurried more on my way home.	「早めに来るのがわかってたら、もっと早く帰って来てたぞ」
「Ah...I suppose that's true...」	「あっ……確かに……」	Ah...I suppose that's true...	「あっ……確かに……」
「I didn't think of that...for some reason.」	「何故か……思いつきませんでした」	I didn't think of that...for some reason.	「何故か……思いつきませんでした」
It should be common sense to do that, but I decide to ignore it.	そうするのが普通のことだと思うが、気にしないことにした。	It should be common sense to do that, but I decide to ignore it.	それが普通のことだと思うが、気にしないことにした。
「Anyway...let's go inside.」	「とにかく……中に入ろうか」	Anyway...let's go inside.	「とにかく……中に入ろうか」
「I see you brought a lot of stuff with you.」	「色々とたくさん持ってきたみたいだな」	I see you brought a lot of stuff with you.	「いろいろとたくさん持ってきたみたいだな」
「That's right.」	「はい」	That's right.	「ああ」
「And did you manage to find everything I asked you to buy as well?」	「頼んだ物、全部買っていただけましたか？」	And did you manage to find everything I asked you to buy as well?	「頼んだ物、全部買っていただけましたか？」
「Yeah, pretty much.」	「ああ、多分」	Yeah, pretty much.	「ああ、たぶん」
「At least, I hope I got everything right.」	「間違えて無ければいいけど」	At least, I hope I got everything right.	「間違えてなければいいけど」
「I'm sure it will be fine.」	「きっと大丈夫ですよ」	I'm sure it will be fine.	「きっと大丈夫ですよ」
I take Yuri to my room.	俺はユリを部屋に連れ込んだ。	I take Yuri to my room.	俺はユリを部屋に招き入れた。
The first thing she does is glance around curiously, which makes me feel anxious.	家に入るなりユリは物珍しそうに周りを見回し、こちらも緊張する。	The first thing she does is glance around curiously, which makes me feel anxious.	家に入るなりユリが物珍しそうに周りを見回したので、こちらも緊張する。
「It's so clean...」	「綺麗ですね……」	It's so clean...	「綺麗ですね……」
「Ahaha...」	「あはは……」	Ahaha...	「そうだな……」
「I cleaned it before you came over, so...」	「来る前に掃除をしておいたからな……」	I cleaned it before you came over, so...	「ユリが来る前に掃除をしておいたからな……」
「That's very considerate of you to do.」	「気を遣ってくださったのですね」	That's very considerate of you to do.	「気を使ってくださったのですね」
「Ah, no...」	「あっ、いや……」	Ah, no...	「ああ、いや……」
「I would be really embarrassed for my room to be a mess while you were here.」	「汚いままの部屋にユリを入れてたら恥ずかしかったしな」	I would be really embarrassed for my room to be a mess while you were here.	「汚いままの部屋にユリを入れるのは恥ずかしかったしな」
「Hmm...」	「ふむ……」	Hmm...	「ふーん……」
「Well, I do enjoy cleaning...」	「でも、お掃除は好きなので……」	Well, I do enjoy cleaning...	「でも、お掃除は好きなので……」
「I would have gladly helped you clean.」	「私も喜んでお手伝いしましたのに」	I would have gladly helped you clean.	「私も喜んでお手伝いしましたのに」
「Ah--」	「いや……」	Ah--	「えっと……」
「That would be even more embarrassing!」	「そしたらもっと恥ずかしいだろ！」	That would be even more embarrassing!	「そしたらもっと恥ずかしいだろ！」
「Wait, don't look in there--!」	「あっ、そこは見るんじゃない――！」	Wait, don't look in there--!	「あっ、そこは見るんじゃない――！」
I snatch Yuri's wrist, which was in the process of opening a desk drawer of mine.	机の引き出しを開けようとしていたユリの手首を掴んだ。	I snatch Yuri's wrist, which was in the process of opening a desk drawer of mine.	机の引き出しを開けようとしていたユリの手首をつかんだ。
「A-Ah...」	「あ、あっ……」	A-Ah...	「う、うん……」
「I'm sorry...!」	「ごめんなさい……！」	I'm sorry...!	「ごめんなさい……！」
「I wasn't thinking for some reason...」	「なぜか考えなしに開けようとしてて……」	I wasn't thinking for some reason...	「なぜか無意識に開けようとしてて……」
「I was just spacing out!」	「ボーッとしてたみたいです……！」	I was just spacing out!	「ボーッとしてたみたいです……！」
「It's fine, it's fine...」	「いいよいいよ……」	It's fine, it's fine...	「いいよいいよ……」
I let go of Yuri's wrist.	俺はユリの手首を放した。	I let go of Yuri's wrist.	俺はユリの手首を放した。
She puts both of her hands firmly in her lap, as if making sure she's keeping track of them.	それ以上勝手をしないようにとユリは両手を膝の上にかたく置いた。	She puts both of her hands firmly in her lap, as if making sure she's keeping track of them.	それ以上勝手をしないようにとユリは両手を膝の上にぎゅっと置いた。
「So, um...」	「それじゃ、その……」	So, um...	「それじゃ、その……」
「Should we...get started?」	「そろそろ……始めようか？」	Should we...get started?	「そろそろ……始めようか？」
「Ah...」	「あっ……」	Ah...	「ああ……」
「Yes...」	「はい……」	Yes...	「はい……」
「Um, I have a few things planned that you can help with...」	「あの、いくつか作りたいものを考えてきたので、それを一緒に作っていただきたいです」	Um, I have a few things planned that you can help with...	「あの、いくつかつくりたいものを考えてきたので、それを一緒につくっていただきたいです」
「Decorations and other atmospheric enhancements.」	「飾り付けや部屋の雰囲気を作り出すものを」	Decorations and other atmospheric enhancements.	「飾りつけや部屋の雰囲気をつくり出すものを」
「Atmospheric enhancements...?」	「部屋の雰囲気を作る……？」	Atmospheric enhancements...?	「部屋の雰囲気をつくる……？」
「You know...」	「例えば……」	You know...	「そう……」
「Mood lighting, aromatherapy candles...」	「間接照明や、アロマキャンドルなど……」	Mood lighting, aromatherapy candles...	「間接照明や、アロマキャンドルなど……」
「Oh, wow.」	「えっ、すごいな」	Oh, wow.	「えっ、すごいな」
「I didn't know you planned on taking it that far.」	「まさかそこまで本格的にやるとは思わなかったよ」	I didn't know you planned on taking it that far.	「そこまで本格的にやるとは思わなかったよ」
「Of course.」	「もちろんです」	Of course.	「やりますよ」
「I want to help take our guests to a faraway place.」	「お客さんを遠いどこかへと誘いたいんです」	I want to help take our guests to a faraway place.	「お客さんを遠いどこかへと誘いたいんです」
「Although many will stop by just out of curiosity...」	「ほとんどは好奇心で覗きに来るでしょうが……」	Although many will stop by just out of curiosity...	「ほとんどは好奇心でのぞきに来る人や……」
「And for...cupcakes, I guess...」	「あとはカップケーキが欲しくて……でしょうね……」	And for...cupcakes, I guess...	「カップケーキがほしい人でしょう……けれど……」
「I'm determined to provide an experience that will leave them wanting more.」	「ですが私は、もっと聞きたいと思わせるような体験を提供したいんです」	I'm determined to provide an experience that will leave them wanting more.	「私は、もっと聞きたいと思わせるような体験を提供したいんです」
「That's great.」	「いいじゃないか」	That's great.	「いいじゃないか」
「It's easy to forget that you're a pretty intense person.」	「お前が結構熱心になるタイプだって忘れてたよ」	It's easy to forget that you're a pretty intense person.	「お前が結構熱心になるタイプだって忘れてたよ」
「Ah--」	「えっ……」	Ah--	「えっと……」
「Intense...?」	「熱心……？」	Intense...?	「熱心……？」
「I guess that's the best way to put it.」	「それが一番しっくりくる言い方かな」	I guess that's the best way to put it.	「それが一番しっくりくる言い方かな」
「Is that...a bad thing?」	「それって……悪いことですか？」	Is that...a bad thing?	「それって……悪いことですか？」
「No, not at all.」	「いや、まったく」	No, not at all.	「いや、まったく」
「It's something that I like about you, actually.」	「むしろそういうところが俺は良いと思うぞ」	It's something that I like about you, actually.	「むしろそういうところが俺は良いと思うぞ」
「I-Is that so...?」	「そ、そうなのですか……？」	I-Is that so...?	「そ、そうですか……？」
「That makes me feel relieved...」	「それを聞いて安心しました……」	That makes me feel relieved...	「それを聞いて安心しました……」
「And kind of happy...」	「それにちょっと嬉しくも思います……」	And kind of happy...	「それにちょっと、うれしくも思います……」
「Yeah, no need to be so anxious.」	「そうそう、そんなに緊張しなくていいんだ」	Yeah, no need to be so anxious.	「そうそう、そんなに緊張しなくていいんだ」
「You can relax a little.」	「少しはリラックスしなよ」	You can relax a little.	「少しはリラックスしなよ」
「Relax...」	「リラックスと言えば……」	Relax...	「リラックスと言えば……」
「I brought some things for relaxation.」	「リラックス効果のあるものを持ってきたんです」	I brought some things for relaxation.	「リラックス効果のあるものを持ってきたんです」
「I was going to use them during the poetry event...」	「出し物で使おうと思いまして……」	I was going to use them during the poetry event...	「出し物で使おうと思いまして……」
「Oh yeah? Like what?」	「へえ、例えばなんだ？」	Oh yeah? Like what?	「へえ、どういうもの？」
「Let's see...」	「例えばですね……」	Let's see...	「そうですね……」
Yuri rummages through her bag.	ユリは自分のカバンを漁る。	Yuri rummages through her bag.	ユリは自分のカバンを漁る。
She pulls out a few candles and a wooden cylinder-shaped object.	そこからキャンドルを数本と、木製の筒型のオブジェを取り出した。	She pulls out a few candles and a wooden cylinder-shaped object.	そこからキャンドルを数本と、木製の筒型オブジェを取り出した。
「I did some shopping on the way here, so I happen to have these in my bag.」	「ここに来る前に買い物をしてきたのでカバンに入れておいたんです」	I did some shopping on the way here, so I happen to have these in my bag.	「ここに来る前に買い物をしてきたので、カバンに入れておいたんです」
「I planned to cover the windows in black paper and use the candles to light the room.」	「部室の窓を黒い紙で覆って、キャンドルで明かりをつけようと思いまして」	I planned to cover the windows in black paper and use the candles to light the room.	「部室の窓を黒い紙で覆って、キャンドルで明かりをつけようと思いまして」
「I think that would be amazing, don't you?」	「そうするととても綺麗だと思いませんか？」	I think that would be amazing, don't you?	「そしたら、とても綺麗だと思いませんか？」
「Yeah, that would be really neat.」	「ああ、すごく良さそうだな」	Yeah, that would be really neat.	「ああ、すごく良さそうだな」
「What's that wooden thing, though?」	「でもこの木のやつはなんだ？」	What's that wooden thing, though?	「でも、この木のやつはなんだ？」
「Oh, this?」	「あっ、これですか？」	Oh, this?	「あっ、これですか？」
「It's a diffuser for essential oils.」	「アロマオイルのディフューザーですよ」	It's a diffuser for essential oils.	「アロマオイルのディフューザーですよ」
「How familiar are you with aromatherapy?」	「アロマについてご存知ですか？」	How familiar are you with aromatherapy?	「アロマについてご存知ですか？」
「Not familiar at all...」	「全く分からん……」	Not familiar at all...	「まったくわからん……」
「Ah, is that so?」	「あっ、そうなのですね」	Ah, is that so?	「あら、そんな感じなんですね」
「It's one of my favorite contributors to a positive atmosphere.」	「良い雰囲気を作り出すのにすごく役立つんですよ」	It's one of my favorite contributors to a positive atmosphere.	「良い雰囲気をつくり出すのに、すごく役立つんですよ」
「Depending on the oils or herbs you choose, you can change the mood of the air itself.」	「選んだオイルやハーブによって、ムードそのものを変えることだってできてしまうんです」	Depending on the oils or herbs you choose, you can change the mood of the air itself.	「選んだオイルやハーブによって、ムードそのものを変えることだってできてしまうんです」
「You can even feel it permeate through your body.」	「全身に浸透していくようにも感じられますよ」	You can even feel it permeate through your body.	「全身に浸透していくようにも感じられますよ」
「Relaxation, positive energy, romance, reflection...」	「リラックス、ポシティブさ、ロマンス、熟考……」	Relaxation, positive energy, romance, reflection...	「リラックス、ポシティブさ、ロマンス、内省……」
「It's almost like magic.」	「魔法のように色んな効果が表れるんです」	It's almost like magic.	「まるで魔法のように」
Yuri takes the cylinder and pushes a switch on the bottom.	ユリは筒を取ると底のスイッチを点けた。	Yuri takes the cylinder and pushes a switch on the bottom.	ユリは筒を取ると底のスイッチをつけた。
In just a moment, a thin ray of vapor begins to spout through a small hole on the top.	次の瞬間、てっぺんの小さな穴から蒸気が細長く吹き出始めた。	In just a moment, a thin ray of vapor begins to spout through a small hole on the top.	次の瞬間、てっぺんの小さな穴から蒸気が細長く吹き出始めた。
「Wow, that smells wonderful.」	「おお、すごくいい匂いがするな」	Wow, that smells wonderful.	「おお、すごくいい匂いがするな」
「What kind of mood is that one for?」	「これはどんなムードのための香りなんだ？」	What kind of mood is that one for?	「これはどんなムードのための香りなんだ？」
「This is a Jasmine essential oil.」	「これはジャスミンの精油です」	This is a Jasmine essential oil.	「これはジャスミンの精油です」
「It smells a little sweet and flowery, right?」	「少し甘くて花のような香りがするでしょう？」	It smells a little sweet and flowery, right?	「少し甘くて花のような香りがするでしょう？」
「Yeah, that's a good way to describe it.」	「ああ、そんな感じがするな」	Yeah, that's a good way to describe it.	「ああ、そんな感じがするな」
「I chose Jasmine for the event because it provides more than relaxation.」	「出し物のために、リラックス効果のあるジャスミンを選んできたんです」	I chose Jasmine for the event because it provides more than relaxation.	「出し物のために、リラックス以上の効果があるジャスミンを選びました」
「Jasmine enhances your emotions and helps you feel them flow through your body.」	「ジャスミンには気持ちを高めて全身に伝わせる効果があります」	Jasmine enhances your emotions and helps you feel them flow through your body.	「ジャスミンには気持ちを高めて全身に伝わせる効果があります」
「You feel warmer, and your heart pounds more heavily.」	「体が温かくなって、ドキドキするようになれるんです」	You feel warmer, and your heart pounds more heavily.	「体が温かくなって、ドキドキするようになるんです」
「Don't you think that will be perfect for sharing our poems?」	「詩を読み聞かせるのにはぴったりだと思いませんか？」	Don't you think that will be perfect for sharing our poems?	「詩を読み聞かせるのにはぴったりだと思いませんか？」
「It does sound suitable...」	「確かにそれがちょうど良さそうだな……」	It does sound suitable...	「確かにちょうど良さそうだ……」
「But you seem to know a lot about this, so I'll trust your opinion with anything.」	「でもユリはかなり詳しいみたいだから、ユリの考えを信用するよ」	But you seem to know a lot about this, so I'll trust your opinion with anything.	「それにユリはかなり詳しいみたいだから、ユリの考えを信用するよ」
Yuri smiles gently, clearly enjoying herself.	ユリは楽しんでる様子で穏やかに笑った。	Yuri smiles gently, clearly enjoying herself.	ユリは楽しんでいる様子で穏やかに笑った。
She again reaches into her bag and pulls out several spools of thin ribbon.	またカバンに手を入れると、今度は細いリボンを何巻か取り出した。	She again reaches into her bag and pulls out several spools of thin ribbon.	またカバンに手を入れると、今度は細いリボンを何巻か取り出した。
「What are those for?」	「それは何に使うんだ？」	What are those for?	「それは何に使うんだ？」
「Well...」	「これは……」	Well...	「今度は……」
「Did you purchase the origami paper I asked you to get?」	「頼んでいた折り紙は買っていただけましたか？」	Did you purchase the origami paper I asked you to get?	「頼んでいた折り紙は買っていただけましたか？」
「Yeah, I have it over here...」	「ああ、ここにあるぞ……」	Yeah, I have it over here...	「ああ、ここにあるぞ……」
「We won't be using the paper for folding origami.」	「折り紙は折るためには使わないんです……」	We won't be using the paper for folding origami.	「この折り紙は折るんじゃなくて……」
「What I'd like to do is write a different word on each paper.」	「そこに一枚一枚、違う言葉を書いていこうと思いまして」	What I'd like to do is write a different word on each paper.	「一枚一枚、違う言葉を書いていこうと思いまして」
「We'll need about a hundred of them.」	「それを百枚ほど作ろうと思います」	We'll need about a hundred of them.	「それを百枚ほどつくろうと思います」
「Oh yeah?」	「へえ？」	Oh yeah?	「あら、そう？」
「What will those be used for?」	「何に使うんだ？」	What will those be used for?	「何に使うんだ？」
「Well, I'm going to cut pieces of ribbon to hang from the doorway of the classroom.」	「まずはリボンを一定の長さで切っていって、教室の入り口に垂らしていってから……」	Well, I'm going to cut pieces of ribbon to hang from the doorway of the classroom.	「まずはリボンを一定の長さに切って、教室の入り口に垂らしてから……」
「Then, we can fasten the paper onto the ribbons to create a doorway curtain.」	「その折り紙をリボンの端につけて、カーテンを作ろうと思ったんです」	Then, we can fasten the paper onto the ribbons to create a doorway curtain.	「この折り紙をリボンにつけて、カーテンをつくろうと思ったんです」
「Wouldn't that be beautiful?」	「綺麗になると思いませんか？」	Wouldn't that be beautiful?	「綺麗だと思いませんか？」
「It would also catch the eye of those passing by the room...」	「通りすがりの人たちの目にも止まりますし……」	It would also catch the eye of those passing by the room...	「通りすがりの人たちの目にも留まりますし……」
「It may attract some to peek inside.」	「そうすると何人かは中を覗いてくれるかもしれません」	It may attract some to peek inside.	「中をのぞいてくれる人がいるかもしれません」
「That's really creative!」	「それってすごい良いアイデアだな！」	That's really creative!	「すごく良いアイデアだな！」
「I had no idea you'd be so good at this, Yuri.」	「ユリがこういうことが得意だったなんて知らなかったよ」	I had no idea you'd be so good at this, Yuri.	「ユリがこういうことが得意だったなんて知らなかったよ」
「Is...that so?」	「そ……そうでしょうか？」	Is...that so?	「そ……そうでしょうか？」
「Well, I suppose I do get a little intense...as you'd put it.」	「あなたが言ったように……熱心になりやすいみたいですね」	Well, I suppose I do get a little intense...as you'd put it.	「あなたが言ったように……熱心になりやすいみたいですね」
「Uhuhu.」	「ふふっ」	Uhuhu.	「ふふっ」
Yuri giggles with red cheeks.	ユリは頰を赤らめてくすくす笑った。	Yuri giggles with red cheeks.	ユリは頰を赤らめて笑った。
Is it just me, or is she more relaxed when it's just the two of us?	俺の気のせいかもしれないが、もしかしてユリは二人っきりの方がリラックスできるのだろうか？	Is it just me, or is she more relaxed when it's just the two of us?	俺の気のせいかもしれないが、もしかしてユリは二人っきりの方がリラックスできるのだろうか？
Or maybe it's the excitement she feels from sharing something that she enjoys.	それとも自分の喜びを誰かと共有することを楽しんでいるのだろうか。	Or maybe it's the excitement she feels from sharing something that she enjoys.	それとも自分の喜びを誰かと共有することを楽しんでいるのだろうか。
「Here's a marker, [player].」	「このマーカーをどうぞ、[player]さん」	Here's a marker, [player].	「マーカーをどうぞ、[player]さん」
「You can write any characters you want.」	「好きな言葉を書いて良いですからね」	You can write any characters you want.	「好きな言葉を書いて良いですからね」
「I'll help you once I finish cutting the ribbons.」	「リボンを切り終わったら私も手伝います」	I'll help you once I finish cutting the ribbons.	「リボンを切り終わったら私も手伝います」
「Ah, alright.」	「ああ、分かった」	Ah, alright.	「ああ、わかった」
Sitting on the floor together, the two of us get to work.	俺たちは床に座って作業に取り掛かった。	Sitting on the floor together, the two of us get to work.	俺たちは床に座って作業に取りかかった。
I carefully draw a different character on each paper, doing my best to manage my bad handwriting.	俺は下手くそな字をなんとか誤魔化そうとしながら、紙に一枚ずつ慎重に言葉を書いていく。	I carefully draw a different character on each paper, doing my best to manage my bad handwriting.	俺はヘタクソな字を何とか誤魔化しながら、一枚ずつ慎重に言葉を書いていく。
Yuri unravels a long strand of red ribbon to her desired length.	ユリは赤いリボンを適切な長さまで伸ばす。	Yuri unravels a long strand of red ribbon to her desired length.	ユリは赤いリボンを適切な長さまで伸ばす。
Then, she reaches into her bag once more and pulls out a pocket knife.	そしてカバンの中に再び手を入れると、中からポケットナイフを取り出した。	Then, she reaches into her bag once more and pulls out a pocket knife.	そしてカバンの中に再び手を入れると、中からポケットナイフを取り出した。
「Eh...?」	「えっ……？」	Eh...?	「え……？」
The knife is strangely beautiful.	変に綺麗なナイフだった。	The knife is strangely beautiful.	変に綺麗なナイフだ。
The silver handle has an intricate pattern of waves etched into it.	その銀製の柄には複雑な模様が彫刻されていた。	The silver handle has an intricate pattern of waves etched into it.	銀製の柄には複雑な模様が彫刻されていた。
The blade itself is gently tinted blue.	刃の部分はしっとりとした青色に輝いている。	The blade itself is gently tinted blue.	刃の部分はほのかな青色に輝いている。
「That's no ordinary pocket knife...」	「普通のポケットナイフじゃないな……」	That's no ordinary pocket knife...	「普通のポケットナイフじゃないな……」
「It looks really fancy.」	「すごく派手だ」	It looks really fancy.	「すごく凝ってる」
「A-Ah...」	「あっ、ああ……」	A-Ah...	「あ、あの……」
「Well...」	「ええと……」	Well...	「その、つまり……」
Embarrassed, Yuri looks away.	ユリは恥ずかしそうに目をそらした。	Embarrassed, Yuri looks away.	ユリは恥ずかしそうに目をそらした。
「What is it?」	「なんだそれは？」	What is it?	「それは？」
「You're going to think it's weird...」	「きっと引くと思います……」	You're going to think it's weird...	「きっと引くと思います……」
「Yuri, whatever it is, I have no reason to judge.」	「ユリ、何があっても偏見を持ったりしないよ」	Yuri, whatever it is, I have no reason to judge.	「ユリ、何があっても偏見を持ったりしないよ」
「To each their own, you know?」	「みんな人それぞれだろ？」	To each their own, you know?	「みんな人それぞれだろ？」
「If you promise you won't be weirded out...」	「絶対引かないって約束してくれましたら……」	If you promise you won't be weirded out...	「絶対引かないって約束してくれましたら……」
「Yeah, I promise.」	「ああ、約束するよ」	Yeah, I promise.	「ああ、約束するよ」
「Alright...」	「じゃあ……」	Alright...	「わかった……」
「The thing is, I'm kind of into knives...」	「実は私、ナイフが好きなんです……」	The thing is, I'm kind of into knives...	「実は私、ナイフが好きなんです……」
「They're just...so pretty...」	「とても……綺麗で……」	They're just...so pretty...	「とても……綺麗で……」
「I-I can't help it!」	「好きで好きでしょうがないんです！」	I-I can't help it!	「好きで好きでしょうがないんです！」
「I don't know what it is...」	「何故かは分かりませんが……」	I don't know what it is...	「何故かはわかりませんが……」
「The combination of craftsmanship and feeling of danger, maybe...」	「職人技と危険な魅力の組み合わせ、でしょうか……」	The combination of craftsmanship and feeling of danger, maybe...	「職人技と危険な雰囲気の組み合わせ、でしょうか……」
「Uu, what am I saying...?」	「うう、私は何を言ってるんでしょう……」	Uu, what am I saying...?	「うう、私は何を言ってるんでしょう……」
「Please don't think I'm weird for this...」	「変だって思わないでください……」	Please don't think I'm weird for this...	「変だって思わないでください……」
「Ahaha.」	「あはは」	Ahaha.	「あははっ」
「You're laughing at me...」	「笑ってるじゃないですか……」	You're laughing at me...	「笑ってるじゃないですか……」
「No, I'm not laughing at you.」	「いや、その事を笑ってるんじゃないぞ」	No, I'm not laughing at you.	「いや、そのことを笑ってるんじゃないぞ」
「It's just funny how nervous you got about sharing.」	「それを言うのにすごく緊張してそうだったから」	It's just funny how nervous you got about sharing.	「すごく緊張して口に出してたからさ」
「It's...well, it's an interesting thing to be into, I guess.」	「その……面白い趣味だと思うよ」	It's...well, it's an interesting thing to be into, I guess.	「その……面白い趣味だと思うよ」
「But I think it kind of suits you.」	「それになんだか似合っているよ」	But I think it kind of suits you.	「それに、何だか似合ってる」
「Suits me...?」	「似合う……？」	Suits me...?	「似合う……？」
「Yeah... It's kind of intense. Ahaha.」	「ああ……熱心なんだな、って。はははっ」	Yeah... It's kind of intense. Ahaha.	「ああ……熱心なんだな、って。はははっ」
「Besides, it's a really cool-looking knife, I can't deny that.」	「それに、かっこいいナイフだってのも分かるしさ」	Besides, it's a really cool-looking knife, I can't deny that.	「それに、かっこいいナイフだってのもわかるしさ」
「It is, isn't it...?」	「そう思いますか……？」	It is, isn't it...?	「そう思いますか……？」
Yuri relaxes her expression once again.	ユリはやっと気を緩めた。	Yuri relaxes her expression once again.	ユリはやっと表情を緩めた。
「Would you like to hold it?」	「持ってみますか？」	Would you like to hold it?	「持ってみますか？」
「Sure, I'll check it out.」	「ああ、もちろん」	Sure, I'll check it out.	「ああ、もちろん」
Yuri carefully hands me the knife, with the handle facing me.	ユリはナイフの柄をこっちに向け、慎重に俺に渡した。	Yuri carefully hands me the knife, with the handle facing me.	ユリはナイフの柄をこっちに向け、慎重に俺に渡した。
I take it and turn it around in my hands.	俺はそれを手に取ると、手の中で回した。	I take it and turn it around in my hands.	俺はそれを受け取り、手の中で回す。
It feels heavy, and extremely solid.	しっかりとしてて、結構重い。	It feels heavy, and extremely solid.	しっかりとしてて、結構重い。
Where do you even get a knife like this...?	こんなナイフどこで手に入れたんだ……？	Where do you even get a knife like this...?	「こんなナイフ、どこで手に入れたんだ……？」
Curious of its sharpness, I feel the point of the knife with my index finger.	ナイフの鋭さがつい気になり、俺は人差し指でナイフの先端を触った。	Curious of its sharpness, I feel the point of the knife with my index finger.	ナイフの鋭さがつい気になり、俺は人差し指でナイフの先端を触った。
「Ow--!」	「いてっ――！」	Ow--!	「いっ――！」
「[player]--!!」	「[player]さん――！」	[player]--!!	「[player]さん――！」
「Why did you do that?!」	「何故そんなことをしたんですか！」	Why did you do that?!	「何故そんなことをしたんですか！」
「I didn't expect it to be that sharp...!」	「こんなに鋭いとは思わなかった……！」	I didn't expect it to be that sharp...!	「こんなに鋭いとは思わなかった……！」
「I barely touched it at all.」	「ほとんど触ってなかったのに」	I barely touched it at all.	「ほんの少し触れただけなのに」
「I-It's my fault!」	「わ、私のせいで！」	I-It's my fault!	「わ、私のせいで！」
「I should have warned you...」	「気をつけるように言うべきでした……」	I should have warned you...	「気をつけるように言うべきでした……」
「This knife is extremely sharp...」	「このナイフは非常に鋭くて……」	This knife is extremely sharp...	「このナイフは非常に鋭くて……」
「It can cut through skin like it's paper.」	「肌も紙を切るかのように切ってしまうんです」	It can cut through skin like it's paper.	「肌でさえ紙のように切れてしまうんです」
「Oh no...」	「大変……」	Oh no...	「どうして……」
A small drop of blood trickles down the side of my finger.	一滴の血が俺の指からしたたる。	A small drop of blood trickles down the side of my finger.	一滴の血が俺の指からしたたる。
Yuri takes my hand and gives the wound a closer look.	ユリは俺の手を取り、間近で傷を観察している。	Yuri takes my hand and gives the wound a closer look.	ユリは俺の手を取り、間近で傷を観察している。
「Ah...」	「ああ……」	Ah...	「なるほど……」
She stares at it and noticeably fidgets.	ユリはじっと傷を見つめ、そわそわした仕草を見せた。	She stares at it and noticeably fidgets.	ユリはじっと傷を見つめ、そわそわした仕草を見せた。
「If you're squeamish, I'll go wash it off now--」	「血が苦手なら、今すぐ洗い流してくるよ――」	If you're squeamish, I'll go wash it off now--	「血が苦手なら、今すぐ洗い流してくるよ――」
「A-Ah!」	「え、あっ！」	A-Ah!	「あ、あっ……！」
Without warning, Yuri puts my finger in her mouth and licks the wound.	何の前触れもなく、ユリは俺の指を咥え、そのまま傷を舐めた。	Without warning, Yuri puts my finger in her mouth and licks the wound.	何の前触れもなく、ユリは俺の指を咥え、そのまま傷を舐めた。
I feel her tongue curl around my finger.	彼女の舌が指に纏わりつくのを感じる。	I feel her tongue curl around my finger.	彼女の舌が指に纏わりつくのを感じる。
Startled, I instinctively pull my hand back.	驚愕し、俺は反射的に手を引っ込める。	Startled, I instinctively pull my hand back.	驚愕し、俺は反射的に手を引っ込める。
「O-Oh...」	「え、あっ……」	O-Oh...	「え、あっ……」
「P-Please forgive me!」	「ご、ごめんなさい！」	P-Please forgive me!	「ご、ごめんなさい！」
「I wasn't thinking!」	「私、つい！」	I wasn't thinking!	「私、つい！」
「I...」	「私……」	I...	「アタシは……」
Yuri lowers her head, her face burning up.	ユリは赤面しながら顔を俯いた。	Yuri lowers her head, her face burning up.	ユリは赤面しながら俯いた。
「Yuri...」	「ユリ……」	Yuri...	「ユリ……」
「That's the most embarrassing thing I've ever done...」	「人生で一番恥ずかしいことをしました……」	That's the most embarrassing thing I've ever done...	「人生で一番恥ずかしいことをしました……」
「How could I do something like that??」	「なんで私があんなことを？」	How could I do something like that??	「どうしてあんなことを？」
「I'm sorry, I'm sorry...」	「ごめんなさい、ごめんなさい……」	I'm sorry, I'm sorry...	「ごめんなさい、ごめんなさい……」
「Ah...」	「ええと……」	Ah...	「ああ……」
Sure, it was a little weird, and it took me by surprise...	確かにちょっと変だったかもしれないし、びっくりもした。	Sure, it was a little weird, and it took me by surprise...	確かにちょっと変だったかもしれないし、びっくりもした。
But I guess she was just trying to help, right...?	でもユリは俺の役に立とうとしてただけだしな……？	But I guess she was just trying to help, right...?	でもユリは俺の役に立とうとしてただけだしな……？
「Yuri, I think you're overreacting a little...」	「ユリ、気にしすぎだと思うぞ……」	Yuri, I think you're overreacting a little...	「ユリ、少し気にしすぎだと思うぞ……」
「Uuuh...」	「うう……」	Uuuh...	「うう……」
She doesn't lift her head.	ユリは顔をあげない。	She doesn't lift her head.	ユリは顔をあげない。
What if she doesn't recover from this for the rest of the afternoon?	もし彼女がずっとこのまま立ち直れずにいたら？	What if she doesn't recover from this for the rest of the afternoon?	もし彼女がずっとこのまま立ち直れずにいたら？
「Alright, you know what...」	「よし、それじゃあ……」	Alright, you know what...	「よし、それじゃあ……」
This might be a stupid thing to do, but I do it anyway.	バカみたいなことかもしれないが、俺はとにかくやる。	This might be a stupid thing to do, but I do it anyway.	バカみたいなことかもしれないが、俺はとにかくやる。
I take Yuri's hand and lick her index finger in return.	俺はユリの手を取って人差し指をお返しに舐めた。	I take Yuri's hand and lick her index finger in return.	俺はユリの手を取って人差し指をお返しに舐めた。
「[player]--!!」	「[player]さん……！」	[player]--!!	「[player]さん――！」
「D-Did you really just do that?」	「い、今のは一体？」	D-Did you really just do that?	「い、今のは一体？」
「N-Now we're even...」	「こ、これでおあいこだな……」	N-Now we're even...	「こ、これでおあいこだな……」
「...」	「……」	...	「……」
Yuri just looks at me like I did something wrong.	ユリは俺が変なことをしたかのように見つめる。	Yuri just looks at me like I did something wrong.	ユリは、俺のことを変な目で見つめる。
「Ahaha...」	「あはは……」	Ahaha...	「あはは……」
「I knew that would be a bad idea...」	「やっぱりするんじゃなかったか……」	I knew that would be a bad idea...	「やっぱりするんじゃなかったか……」
If not for the sweet aroma of the Jasmine oil, the air would be extremely heavy right now.	ジャスミンのアロマがなければ、きっと今の空気は重苦しかっただろう。	If not for the sweet aroma of the Jasmine oil, the air would be extremely heavy right now.	ジャスミンの甘い香りが無ければ、きっと重苦しい空気になっていただろう。
「You're so weird, [player].」	「本当に変な人ですね、[player]さんは」	You're so weird, [player].	「本当に変な人ですね、[player]さんは」
Yuri giggles shyly.	ユリは恥ずかしそうにくすくす笑った。	Yuri giggles shyly.	ユリは恥ずかしそうにくすくす笑った。
「Eh...?」	「えっ……？」	Eh...?	「え……？」
Yuri calling <i>me</i> weird?	ユリが<i>俺を</i>変って言ったのか？	Yuri calling <i>me</i> weird?	ユリが<i>俺を</i>変って言ったのか？
I have no response to that...	返す言葉がない……	I have no response to that...	返す言葉がない……
「Where do you keep your bandages?」	「絆創膏はどこですか？」	Where do you keep your bandages?	「絆創膏はどこですか？」
「Ah...」	「ああ……」	Ah...	「あの……」
「I don't think I need one, actually.」	「多分なくても大丈夫だ」	I don't think I need one, actually.	「なくてもたぶん大丈夫だ」
「It was a tiny cut.」	「小さい切り傷だったし」	It was a tiny cut.	「小さい切り傷だし」
「Look, it already stopped bleeding.」	「ほら、血ももう止まってるし」	Look, it already stopped bleeding.	「ほら、血ももう止まってる」
「I see...」	「そうでしたか……」	I see...	「そうか……」
「That's relieving.」	「安心しました」	That's relieving.	「安心しました」
The tension is quickly lifted.	すぐに俺たちの雰囲気は元通りになった。	The tension is quickly lifted.	すぐに雰囲気は元通りになった。
We each resume our respective activities.	俺たちはそれぞれの作業を再開した。	We each resume our respective activities.	俺たちはそれぞれの作業を再開した。
I watch Yuri's knife cut through the ribbon like it's nothing but air.	俺はユリのナイフがリボンを空気のように切っていく様子を眺める。	I watch Yuri's knife cut through the ribbon like it's nothing but air.	ユリのナイフがリボンを空気のように切っていく様子を眺める。
Meanwhile, I continue to make progress on the paper.	一方、俺は紙の作業を進める。	Meanwhile, I continue to make progress on the paper.	眺めながら、紙の作業も進めた。
After we finish attaching the paper to the ribbons, we lay them all out side by side.	リボンに紙をつけ終わったとこで、全部横に並べてみた。	After we finish attaching the paper to the ribbons, we lay them all out side by side.	紙をリボンにつけ終わったところで、全部横に並べてみた。
It looks better than I expected and will be very effective as a door curtain.	思った以上の出来になった。これならカーテンとしての効果は絶大だろう。	It looks better than I expected and will be very effective as a door curtain.	想像以上の出来だ。これならカーテンとしての効果は絶大だろう。
「It looks great.」	「良い感じになったな」	It looks great.	「良い感じになったな」
「Good thinking coming up with this, Yuri.」	「よくこんなこと思いつくな、ユリ」	Good thinking coming up with this, Yuri.	「よくこんなこと思いつくな、ユリ」
「Ah, thanks...」	「あ、ありがとうございます……」	Ah, thanks...	「あ、ありがとうございます……」
「It's just something I saw online, really.」	「たまたまネットで見ただけですから……」	It's just something I saw online, really.	「たまたまネットで見ただけですから……」
「Are you ready to move onto the next task?」	「それでは、次の作業に取り掛かりましょうか？」	Are you ready to move onto the next task?	「それでは、次の作業に取り掛かりましょうか？」
「Yeah, let's do it.」	「ああ、やるか」	Yeah, let's do it.	「ああ、そうしよう」
「What do you have in mind?」	「何をするんだ？」	What do you have in mind?	「何をするんだ？」
「I'd like to create a banner.」	「横断幕を作りたいんです」	I'd like to create a banner.	「横断幕をつくりたいんです」
「That's why I asked you to buy the paint tablets.」	「そのために絵の具セットを買っていただくようにお願いしていたんです」	That's why I asked you to buy the paint tablets.	「絵の具セットをお願いしたのはそのためです」
「Ah, that's right.」	「ああ、なるほどな」	Ah, that's right.	「ああ、なるほどな」
One of the items Yuri had asked me to buy was a kit of watercolor paint tablets.	ユリに頼まれてた買い物の一つは水彩絵の具のセットだ。	One of the items Yuri had asked me to buy was a kit of watercolor paint tablets.	ユリに頼まれてた買い物の一つは水彩絵の具のセットだ。
「We'll need about six cups of water to put each of the tablets in.」	「それぞれの絵の具を入れるために水が６杯ほど必要ですね」	We'll need about six cups of water to put each of the tablets in.	「それぞれの絵の具を入れるために、お水が６つ必要ですね」
「Do you mind fetching those for us?」	「取ってきていただいてもいいですか？」	Do you mind fetching those for us?	「持って来ていただいてもいいですか？」
「Of course not.」	「もちろんだ」	Of course not.	「もちろんだよ」,Must
「Six cups of water...」	「水６杯だな……」	Six cups of water...	「水６杯だな……」
「I'll be right back in a minute.」	「すぐに取ってくるよ」	I'll be right back in a minute.	「すぐに取ってくるよ」
「Thank you very much.」	「ありがとうございます」	Thank you very much.	「ありがとうございます」
「Oh, and just a little bit of water is okay.」	「あっ、水は少量で結構です」	Oh, and just a little bit of water is okay.	「あっ、水は少量で結構です」
「If you fill the cups too much, it will be too diluted.」	「水が多すぎると薄くなってしまうので」	If you fill the cups too much, it will be too diluted.	「水が多すぎると薄くなってしまうので」
Taking Yuri's advice, I decide to use small plastic bathroom cups rather than full-sized glasses.	ユリのアドバイスを受けて、俺は普通のカップより小さめの洗面所用のカップを使うことにした。	Taking Yuri's advice, I decide to use small plastic bathroom cups rather than full-sized glasses.	ユリのアドバイスを受けて、俺は普通のカップより小さめの洗面所用のカップを使うことにした。
I put them on a plate to catch any paint that drips, then bring it back into my room.	作業中に落ちる絵の具を受け止めるようにカップをトレイに乗せて、部屋に戻った。	I put them on a plate to catch any paint that drips, then bring it back into my room.	作業中に垂れる絵の具を受け止められるようにカップをトレイに乗せて、部屋に戻った。
「Yuri?」	「ユリ？」	Yuri?	「ユリ？」
「Yes?」	「はい？」	Yes?	「はい？」
I come in to see Yuri quickly unrolling her sleeve, pulling it back over her arm.	部屋に入ると、捲ってた袖をさっと元に戻すユリの姿が見えた。	I come in to see Yuri quickly unrolling her sleeve, pulling it back over her arm.	部屋に入ると、捲った袖を素早く元に戻すユリの姿が見えた。
「Ah, nothing...」	「ああ、なんでもない……」	Ah, nothing...	「あれ、何か……」
「Your face is a little red.」	「なんだか顔が赤いぞ」	Your face is a little red.	「何だか顔が赤いぞ」
「Is it too hot in here, or anything?」	「ここ、暑すぎるか？」	Is it too hot in here, or anything?	「ここ、暑すぎるか？」
「Ah--」	「あっ……」	Ah--	「あっ――」
「No, not at all!」	「いえ、そんなことはありません！」	No, not at all!	「いえ、そんなことはありません！」
「There's nothing wrong, so...」	「なんともありませんから……」	There's nothing wrong, so...	「何ともありませんから……」
「Let's mix the paint.」	「絵の具を混ぜましょうか」	Let's mix the paint.	「絵の具を混ぜましょうか」
Yuri hurriedly dismisses me and takes it upon herself to unwrap the tablets, dropping them into the cups.	ユリはさっさと俺の疑問を片付けると、自分から進んで絵の具を取り出してカップに一つずつ入れ始めた。	Yuri hurriedly dismisses me and takes it upon herself to unwrap the tablets, dropping them into the cups.	ユリは俺の疑問をすげなくかわすと、自ら絵の具を取り出してカップに入れ始めた。
「So...」	「この横幕ですが……」	So...	「それで……」
「I thought we would do something simple that would look very nice.」	「シンプルで見栄えがいいものを作ろうと思います」	I thought we would do something simple that would look very nice.	「シンプルで見栄えがいいものをつくろうと思います」
「I'd like to paint a gradient across the banner...」	「まずはグラデーションを塗りたいですね……」	I'd like to paint a gradient across the banner...	「まずは背景をグラデーションにしたいですね……」
「Starting with the colors for a sunrise, then daytime, then sunset and nighttime.」	「日の出の色から始めて、日中、夕日、夜といったように」	Starting with the colors for a sunrise, then daytime, then sunset and nighttime.	「日の出の色から始めて、日中、夕日、夜といったように」
「Once it dries, I'll write an inspirational quote across the banner.」	「それが乾いたら、心に響く名言を大きく書きます」	Once it dries, I'll write an inspirational quote across the banner.	「それが乾いたら、心に響く名言を大きく書きます」
「We can hang it on the wall behind the podium at the front of the classroom.」	「そしてそれを教室の正面の、教卓の後ろの壁に飾るんです」	We can hang it on the wall behind the podium at the front of the classroom.	「そしてそれを教室の正面の、教卓の後ろに飾るんです」
「Ah, neat.」	「へえ、面白そうだな」	Ah, neat.	「へえ、面白そうだな」
「What are you going to write?」	「どんな名言を書くんだ？」	What are you going to write?	「どんな名言を書くんだ？」
「Well...」	「それは……」	Well...	「えっと……」
「...It will be more fun to surprise you.」	「……見てからのお楽しみにしておきます」	...It will be more fun to surprise you.	「……見てからのお楽しみです」
Yuri smiles at me.	ユリは俺を向いてにっこり笑った。	Yuri smiles at me.	ユリは俺ににっこり笑顔を向けた。
「If you say so...」	「そう言うのなら……」	If you say so...	「そっか……」
After rolling out the banner, Yuri and I kneel on opposite sides so we don't get in the way of each other.	横幕を広げると俺たちはお互いの邪魔にならないように、端と端に別れて膝をついた。	After rolling out the banner, Yuri and I kneel on opposite sides so we don't get in the way of each other.	横断幕を広げ、お互いの邪魔にならないように、両端に分かれて膝をつく。
Yuri uses a brush and adds a few dots of different colors across the banner to serve as a color guide when we paint.	ユリは筆で横幕に色の点をいくつか置いて、色を塗る目印を作った。	Yuri uses a brush and adds a few dots of different colors across the banner to serve as a color guide when we paint.	ユリは筆で色の点をいくつか置いて、着色の目印をつくった。
「This kind of reminds me of elementary school...」	「なんだかこうしてると小学校を思い出すな……」	This kind of reminds me of elementary school...	「何だか、小学校を思い出すな……」
Painting on a banner with watercolors feels a lot like the art class projects we had back then.	横幕に絵の具で色を塗るなんて、なんだか図工の時間みたいだ。	Painting on a banner with watercolors feels a lot like the art class projects we had back then.	横断幕に絵の具で色を塗るなんて、まるで図工の時間みたいだ。
It's relaxing.	そう思うとなんだか落ち着く。	It's relaxing.	心が落ち着く。
「Ah...」	「あっ……」	Ah...	「ああ……」
「I'm sorry if this feels too childish...!」	「子供っぽいことをさせてごめんなさい……！」	I'm sorry if this feels too childish...!	「子どもっぽいことをさせてごめんなさい……！」
「No, I didn't mean that at all.」	「いや、全くそんなことないぞ」	No, I didn't mean that at all.	「いや、そういう意味じゃない」
「It's kind of fun, you know?」	「なんだか楽しいと思わないか？」	It's kind of fun, you know?	「むしろ楽しいと思わないか？」
「...Yeah.」	「……はい」	...Yeah.	「……そうだけど」
「It is fun.」	「楽しいです」	It is fun.	「楽しいです」
「I'm glad you feel that way, too.」	「あなたも同じで良かったです」	I'm glad you feel that way, too.	「あなたも同じで良かったです」
Yuri stops painting for a moment, thinking to herself.	ユリは色を塗る手を止めて、しばらく考え込んだ。	Yuri stops painting for a moment, thinking to herself.	ユリは色を塗る手を少し止めて、考え込んでいる。
「For me...」	「私にとって……」	For me...	「私にとって……」
「I don't need to go out and do crazy things to have fun.」	「楽しいことって、外に出て思い切り遊ぶことではないんです」	I don't need to go out and do crazy things to have fun.	「楽しいことって、外に出て思い切り遊ぶことではないんです」
「In fact, I usually don't even want to.」	「むしろ、ほとんどの場合はそうしたくないんです」	In fact, I usually don't even want to.	「むしろ、ほとんどの場合はそうしたくないんです」
「I just like when I can spend time with one other person...」	「誰かもう一人と一緒に過ごすのが好きで……」	I just like when I can spend time with one other person...	「誰かと二人だけで過ごすのが好きで……」
「Even if it's something simple, like reading - it doesn't even matter if we don't talk much.」	「たとえ一緒にすることが読書や、そんな単純なことでも……あまり喋らなくたって良いんです」	Even if it's something simple, like reading - it doesn't even matter if we don't talk much.	「例え一緒にすることが読書や、そんな単純なことでも……あまりしゃべらなくたって良いんです」
「Just having a friend next to me makes things feel a little bit nicer.」	「隣に友達が一人いてくれるだけで少し嬉しくなれるんです」	Just having a friend next to me makes things feel a little bit nicer.	「隣に友達が一人いてくれるだけで、少しうれしくなれるんです」
「I think that's all it takes for me to be happy.」	「それだけで私は十分幸せなんだと思います」	I think that's all it takes for me to be happy.	「それだけで私は十分幸せなんだと思います」
「Is that so...?」	「そうなのか……」	Is that so...?	「そうなのですね……」
Even if Yuri and I are quite different, I can understand where she's coming from.	俺とユリは結構性格が違うが、なんだか言ってることが分かる気がする。	Even if Yuri and I are quite different, I can understand where she's coming from.	俺とユリは結構性格が違うが、言ってることはわかる気がする。
I feel that way about things like anime and games, where simply sharing the experience with someone can make me happy.	俺もアニメやゲームのことになると、誰かと一緒に体験するだけで楽しくなれる。	I feel that way about things like anime and games, where simply sharing the experience with someone can make me happy.	俺もアニメやゲームのことになると、誰かと体験を共有するだけで楽しくなれる。
「I think I feel the same way.」	「多分俺も同じ気持ちだ」	I think I feel the same way.	「たぶん、俺もそうだ」
Yuri smiles gently.	ユリは微笑んだ。	Yuri smiles gently.	ユリは微笑んだ。
「I knew you'd understand...」	「あなたならきっと分かっていただけると思ってました……」	I knew you'd understand...	「きっとわかっていただけると思ってました……」
Yuri leans over the banner to grab an unused paintbrush.	ユリは横幕の上から身を乗り出してまだ使ってない筆を手に取った。	Yuri leans over the banner to grab an unused paintbrush.	ユリは横断幕の上から身を乗り出してまだ使っていない筆を手に取った。
But I move at the same time, causing my head to bump into hers.	だが俺も同時に動いたことで、俺たちは頭からぶつかってしまった。	But I move at the same time, causing my head to bump into hers.	だが俺も同時に動いたことで、俺たちは頭からぶつかってしまった。
「Kya--!」	「きゃっ……！」	Kya--!	「きゃっ――！」
「S-Sorry!」	「わ、悪い！」	S-Sorry!	「ご、ごめんなさい！」
Yuri reels back, and I quickly lift my hands in surprise.	ユリは後ずさりし、俺は驚いて両手を挙げた。	Yuri reels back, and I quickly lift my hands in surprise.	ユリは後ずさりし、俺は驚いて両手を上げた。
「Are you hurt?」	「痛かったか？」	Are you hurt?	「痛かったか？」
「N-No, I'm not hurt.」	「い、いえ、痛くはありません」	N-No, I'm not hurt.	「い、いえ、痛くはありません」
「It just startled me...that's all.」	「びっくり……しただけです」	It just startled me...that's all.	「びっくり……しただけです」
「Sorry, I should have asked you to get it for me...」	「ごめんなさい、代わりに取っていただくようにお願いするべきでした」	Sorry, I should have asked you to get it for me...	「ごめんなさい、代わりに取っていただくようにお願いするべきでした」
「It's not your fault.」	「ユリのせいじゃないよ」	It's not your fault.	「ユリのせいじゃないよ」
「Ah, your face...」	「あっ、ユリ、顔が……」	Ah, your face...	「あっ、ユリ、顔が……」
There are droplets of paint on Yuri's face and neck.	ユリの顔と首に絵の具がついてしまっている。	There are droplets of paint on Yuri's face and neck.	ユリの顔と首に絵の具が飛び散っている。
「Is there something on my face?」	「私の顔に何かついてます？」	Is there something on my face?	「私の顔に何かついてます？」
「Yeah, I accidentally got paint on you...」	「ああ、間違って絵の具をかけてしまった……」	Yeah, I accidentally got paint on you...	「ああ、間違って絵の具をかけてしまった……」
「Sorry, it's totally my fault!」	「すまん、完全に俺のせいだ！」	Sorry, it's totally my fault!	「すまん、完全に俺のせいだ！」
「I'll get a towel right away.」	「すぐタオルを取ってくる」	I'll get a towel right away.	「すぐタオルを取ってくる」
I rush out and fetch a small towel, then I dampen it with hot water.	俺は走って部屋を出て、小さめのタオルを取るとお湯で濡らした。	I rush out and fetch a small towel, then I dampen it with hot water.	俺は走って部屋を出て、小さめのタオルを取るとお湯で濡らした。
I return to my room and kneel back down in front of her.	部屋に戻って俺はユリの前で膝をついた。	I return to my room and kneel back down in front of her.	部屋に戻り、ユリの前で膝をつく。
「Here...」	「ほら……」	Here...	「ほら……」
I pat down Yuri's face and neck with the towel.	俺はユリの顔と首を拭いていく。	I pat down Yuri's face and neck with the towel.	タオルでユリの顔と首を拭いていく。
「Ah--」	「あっ……」	Ah--	「あっ――」
「Is something wrong?」	「どうかしたのか？」	Is something wrong?	「どうかしたのか？」
「It's hot...I just didn't expect it.」	「熱いとは……思わなかったので……」	It's hot...I just didn't expect it.	「熱いとは……思わなかったので……」
「Sorry...」	「悪い……」	Sorry...	「悪い……」
「I didn't want to use cold water.」	「冷水は使いたくなかったんだ」	I didn't want to use cold water.	「冷水は使いたくなかったんだ」
Having finished, I start to retract my hand.	拭き終わって、俺は手を引こうとした。	Having finished, I start to retract my hand.	拭き終わって、俺は手を引こうとした。
But Yuri suddenly holds my wrist.	だが、ユリが突然俺の手首を掴んだ。	But Yuri suddenly holds my wrist.	だが、ユリが突然俺の手首をつかんだ。
「Wait--」	「待って――」	Wait--	「待って――」
「Eh?」	「え？」	Eh?	「えっ？」
「Just...for a little longer.」	「もう少し……このまま」	Just...for a little longer.	「もう少し……このまま」
「It feels really nice...」	「とても……心地いいんです」	It feels really nice...	「とても……心地いいんです」
「Ah...」	「あ……」	Ah...	「ああ……」
I keep my hand still against Yuri's neck.	俺はユリの首の横に手を添えたままにする。	I keep my hand still against Yuri's neck.	ユリの首の横に手を添えたままにする。
She looks into my eyes.	ユリは俺の目を見つめる。	She looks into my eyes.	ユリが、俺の目を見つめる。
It's an intense expression that I recognize from when she reads her books...	本を読んでる時のような真剣な顔だ……	It's an intense expression that I recognize from when she reads her books...	本を読む時のような真剣な顔……
Almost as if she's lost in a daze, enveloped by her own thoughts.	自分の思考に包み込まれて、ボーッとしているようだ。	Almost as if she's lost in a daze, enveloped by her own thoughts.	自分の思考に包み込まれて、ぼんやりとしているようだ。
She breathes gently, half through slightly-parted lips.	少しだけ唇を開いて、ゆっくりと呼吸している。	She breathes gently, half through slightly-parted lips.	唇を少しだけ開いて、ゆっくりと呼吸している。
What is happening...?	何だこれは……？	What is happening...?	いったい、何が起きてるんだ……？
Is it the aroma of the Jasmine oil giving me this dizzy feeling?	この目の回るような感覚もジャスミンの影響なのか？	Is it the aroma of the Jasmine oil giving me this dizzy feeling?	この目の回るような感覚もジャスミンの影響なのか？
Yuri's gentle fingers, wrapped around my wrist, send a tingling sensation through my arm.	ユリの柔らかい指が俺の手首に絡みついて腕がうずく。	Yuri's gentle fingers, wrapped around my wrist, send a tingling sensation through my arm.	ユリの柔らかい指が俺の手首に絡みついて腕がうずく。
And suddenly, her face seems to be much closer to mine than it was just a moment ago...	それに顔もさっきより近くなってきている気がする……	And suddenly, her face seems to be much closer to mine than it was just a moment ago...	それに顔もさっきより近くなってきている気がする……
「Ah...」	「あっ……」	Ah...	「ああ……」
Yuri slowly pulls away.	ユリはゆっくり身を引いた。	Yuri slowly pulls away.	ユリはゆっくり身を引いた。
「Sorry...」	「ごめんなさい……」	Sorry...	「ごめんなさい……」,Must
「I've been feeling a little light-headed today.」	「なんだか今日は頭がふわふわするんです」	I've been feeling a little light-headed today.	「今日は何だか、頭がふわふわするんです」
「I didn't mean to space out...」	「ボーッとするつもりはなかったのですが……」	I didn't mean to space out...	「ボーッとするつもりはなかったのですが……」
「I-It's fine...」	「い、いいんだ」	I-It's fine...	「い、いいんだ」
The moment is over as soon as it began.	このひと時も一瞬で終わってしまった。	The moment is over as soon as it began.	このひと時も一瞬で終わってしまった。
Yuri picks up her brush again.	ユリは再び筆を手に取った。	Yuri picks up her brush again.	ユリは再び筆を手に取った。
But her movements seem clumsier, like she's unable to focus.	だが集中できないようで、動きがさっきよりぎこちない。	But her movements seem clumsier, like she's unable to focus.	だが集中できないようで、動きがさっきよりぎこちない。
I remain silent, forced to ignore the event that just transpired.	今の出来事を忘れることを強いられ、俺は無言のままでいる。	I remain silent, forced to ignore the event that just transpired.	今の出来事を無視するよう強いられ、俺は無言のままでいる。
I hesitantly retrieve my own brush and continue following Yuri's example.	俺はしぶしぶ筆を取ってユリと同じように色塗りを再開した。	I hesitantly retrieve my own brush and continue following Yuri's example.	俺はしぶしぶ筆を取り、ユリにならって色塗りを再開した。
「That should do it...」	「こんなもんだな……」	That should do it...	「こんなもんだな……」
I finish filling the night sky with white dots that look like stars.	俺は横幕に描かれた夜空を星に見立てた白い点でいっぱいにした。	I finish filling the night sky with white dots that look like stars.	横断幕に描かれた夜空を星に見立てた白い点でいっぱいにした。
Looking at the banner as a whole, it's very pretty and natural-looking.	横幕を全体で見ると、すごく綺麗で自然だ。	Looking at the banner as a whole, it's very pretty and natural-looking.	全体を見渡すと、すごく綺麗で自然だ。
「I think it came out better than I expected.」	「予想以上の出来だと思います」	I think it came out better than I expected.	「予想以上の出来だと思います」
「I'm really happy with the results.」	「綺麗に仕上がって本当に嬉しいです」	I'm really happy with the results.	「綺麗に仕上がって、本当にうれしいです」
「Yeah, me too.」	「ああ、俺もだ」	Yeah, me too.	「ああ、俺もだ」
「Are you going to add the lettering now?」	「そろそろ文字を書き始めるか？」	Are you going to add the lettering now?	「そろそろ文字を書き始めるか？」
「Ah, not yet...」	「あっ、まだです……」	Ah, not yet...	「あっ、まだです……」
「It needs to dry first.」	「まだ絵の具が乾ききってないので」	It needs to dry first.	「まだ絵の具が乾ききってないので」
「That's true, but won't that take a while?」	「確かにそうだが、待ってたら時間がかからないか？」	That's true, but won't that take a while?	「確かにそうだが、待ってたら時間がかからないか？」
「Well...」	「それなら……」	Well...	「えっと……」
「Perhaps it would be best to leave it here, then have you bring it in the morning.」	「一晩ここで乾かして、朝に持ってきていただいた方が良いかもしれません」	Perhaps it would be best to leave it here, then have you bring it in the morning.	「一晩ここで乾かして、朝に持ってきていただいた方が良いかもしれません」
「I can do the lettering in the classroom before our event starts.」	「文字は文化祭が始まる前に教室で書けますし」	I can do the lettering in the classroom before our event starts.	「文字は文化祭が始まる前に教室で書けますし」
「Is that okay?」	「お願いしても良いですか？」	Is that okay?	「お願いしてもいいですか？」
「That's totally fine.」	「構わないよ」	That's totally fine.	「構わないよ」
「Wonderful.」	「良かった」	Wonderful.	「良かった」
「In that case...」	「そういうことでしたら……」	In that case...	「そういうことなら……」
「I don't think there's anything more for us to do here.」	「これでやることは全て終わりましたね」	I don't think there's anything more for us to do here.	「これでやることはすべて終わりましたね」
「Phew.」	「ふう……」	Phew.	「ふう……」
「Ahaha.」	「あはは」	Ahaha.	「あはは」
「You say that like you're glad it's over.」	「まるで終わって良かったみたいですね」	You say that like you're glad it's over.	「終わってうれしい、みたいなため息ですね」
「Was I wrong to assume that you were at least enjoying yourself a little bit?」	「少しは楽しんでいると思っていましたが、思い上がりでしたか？」	Was I wrong to assume that you were at least enjoying yourself a little bit?	「少しは楽しんでいると思っていましたが、違いましたか？」
「Ah, no, it's not that.」	「あ、いや、そうじゃない」	Ah, no, it's not that.	「あ、いや、そうじゃない」
「I'm just glad that we managed to get everything done.」	「無事全部済ませて良かったと思って」	I'm just glad that we managed to get everything done.	「無事に全部済ませることができて良かったと思って」
「I see.」	「そうでしたか」	I see.	「なるほど」
「I am, too.」	「私もそう思います」	I am, too.	「私もそう思います」
「I was a little concerned about time...」	「ちょっと時間が気になっていたので……」	I was a little concerned about time...	「ちょっと時間が気になっていたので……」
「I need to start making dinner soon.」	「早く夕食を作らないと」	I need to start making dinner soon.	「早く夕飯をつくらないと」
「Ah...」	「あっ……」	Ah...	「ああ……」
「So you don't have any time left?」	「もう帰らないといけないのか？」	So you don't have any time left?	「もう帰らないといけないのか？」
I was secretly hoping we would have extra time after finishing the work...	内心、終わったあとも時間が取れることを期待していたが……	I was secretly hoping we would have extra time after finishing the work...	内心、終わったあとも時間が取れることを期待していたが……
「Well...」	「その……」	Well...	「えっと……」
「...」	「……」	...	「……」
Yuri thinks to herself.	ユリは考え込んだ。	Yuri thinks to herself.	ユリは考える。
「I-I think it would be too irresponsible of me to wait much longer...」	「これ以上待ってるのも無責任かもしれないので……」	I-I think it would be too irresponsible of me to wait much longer...	「これ以上待ってるのも無責任かもしれないので……」
「I'm sorry!」	「ごめんなさい！」	I'm sorry!	「ごめんなさい！」
「I was hoping there would be more time as well...」	「私ももう少し時間が欲しかったのですが……」	I was hoping there would be more time as well...	「私ももう少し時間がほしかったのですが……」
「It's probably my fault.」	「多分俺のせいだな」	It's probably my fault.	「たぶん俺のせいだな」
「Sorry for being such a slow worker.」	「仕事がのろくてすまなかったな」	Sorry for being such a slow worker.	「仕事がのろくてすまなかったな」
「No, it's not your fault at all.」	「いえ、あなたのせいではありません」	No, it's not your fault at all.	「いえ、あなたのせいではありません」
「And...the important thing is that we got everything done, right?」	「それに……大事なのは時間内に全部終えられたことでしょう？」	And...the important thing is that we got everything done, right?	「それに……大事なのは時間内に全部終えられたことでしょう？」
「Yeah...」	「そうだな……」	Yeah...	よし……
「So...」	「だから……」	So...	「だから……」
「I shouldn't be disappointed...or anything.」	「私もがっかりする必要も……ないはずなのに」	I shouldn't be disappointed...or anything.	「私もがっかりする必要は……ないはずなのに」
Gathering all her things, Yuri seems to look a little downcast.	荷物をまとめるユリがちょっとしゅんとしたように見える。	Gathering all her things, Yuri seems to look a little downcast.	荷物をまとめるユリがちょっとしゅんとしたように見える。
I understand why.	気持ちは分かる。	I understand why.	気持ちはわかる。
It sounded like she rarely gets the opportunity to spend time with friends in a relaxed environment.	こうやって落ち着ける環境で友達と過ごすことは滅多にないのだろう。	It sounded like she rarely gets the opportunity to spend time with friends in a relaxed environment.	こうやって落ち着ける環境で友達と過ごすことは滅多にないのだろう。
But that doesn't mean this is the last time it can happen...	これが最後とも限らないのに……	But that doesn't mean this is the last time it can happen...	これが最後とは限らないのに……
Once Yuri packs up, I walk her out the front door.	ユリが帰り支度を済ませると、俺は外まで見送りに出た。	Once Yuri packs up, I walk her out the front door.	帰り支度を済ませたユリを外まで見送りに出た。
「Thank you very much for having me today.」	「今日はお手伝いしていただいてありがとうございました」	Thank you very much for having me today.	「今日はお手伝いしていただいてありがとうございました」
「No problem, I'm glad I was able to help.」	「いいよ、俺も役に立てて良かったよ」	No problem, I'm glad I was able to help.	「いいよ、俺も役に立てて良かったよ」
「Just let me know if there's anything else you need me to bring tomorrow.」	「明日他に必要なものがあればまた連絡してくれよ」	Just let me know if there's anything else you need me to bring tomorrow.	「明日必要なものが他にもあればまた連絡してくれよ」
「I will.」	「はい」	I will.	「はい」
「Well, then...」	「それでは……」	Well, then...	「それでは……」
Yuri fidgets.	ユリはそわそわしている。	Yuri fidgets.	ユリはそわそわしている。
「I guess...I'll see you tomorrow.」	「また明日……ですね」	I guess...I'll see you tomorrow.	「また明日……ですね」
「Wait--」	「待て……」	Wait--	「待って――」
I kind of say that without thinking.	ほぼ考えなしに俺は言った。	I kind of say that without thinking.	ほぼ考えなしに俺は言った。
「About today...」	「今日のことなんだが……」	About today...	「今日のことなんだが……」
「It's fine that we didn't have as much time as we wanted.」	「今日時間が足りなかったとしても大丈夫だ」	It's fine that we didn't have as much time as we wanted.	「今日時間が足りなかったとしても大丈夫だ」
「Because we can do this again.」	「またいつでも出来るんだから」	Because we can do this again.	「またいつでもできるだろ？」
「Whenever you want, you can come over, or we can go out somewhere--」	「いつでも遊びに来ていいし、どっか出掛けたりしても……」	Whenever you want, you can come over, or we can go out somewhere--	「いつでも遊びに来ていいし、どっか出かけたりしても……」
「Ah, I forgot you don't like going out much--」	「あ、そっか、遊びに行くのはあまり好きじゃなかったんだよな……」	Ah, I forgot you don't like going out much--	「あ、そっか、出かけるのはあまり好きじゃなかったんだよな……」
As I stumble over my words, Yuri simply smiles bashfully.	俺が言葉に詰まっていると、ユリははにかんだ。	As I stumble over my words, Yuri simply smiles bashfully.	俺が言葉に詰まっていると、ユリははにかんだ。
「Anyway...」	「とにかく……」	Anyway...	「じゃあ……」
「You know what I'm trying to say, so...」	「俺の言いたいことは分かるだろ？ その……」	You know what I'm trying to say, so...	「俺の言いたいことはわかるだろ？ その……」
「You're very thoughtful, [player].」	「本当に思いやりのある方なんですね、[player]さんは」	You're very thoughtful, [player].	「本当に思いやりのある方なんですね、[player]さんは」
Yuri takes a step closer to me, then briefly squeezes my hand.	ユリは一歩俺に近づくと、俺の手をぎゅっと握った。	Yuri takes a step closer to me, then briefly squeezes my hand.	ユリは一歩俺に近づくと、俺の手をそっと握った。
「I kind of like that about you...」	「そんなところが好きです……」	I kind of like that about you...	「そんなところが好きです……」
「Well...」	「それは……」	Well...	「えっと……」
How am I supposed to respond to that?	俺はどう返せばいいんだ？	How am I supposed to respond to that?	一体どういう反応をすればいいんだ？
But I don't even get a chance to, as Yuri suddenly pulls back.	返す言葉が出る前に、ユリが突然後ろに引いた。	But I don't even get a chance to, as Yuri suddenly pulls back.	返す言葉が出る前に、ユリが突然後ろに引いた。
「S-Sayori--?」	「サ、サヨリちゃん……？」	S-Sayori--?	「サ、サヨリちゃん……？」
「Eh?!」	「えっ！？」	Eh?!	「えっ！？」
「Ah...」	「あっ……」	Ah...	「ああ……」
「H-Hi, [player]...」	「や、やっほー[player]……」	H-Hi, [player]...	「や、やっほー、[player]……」
「Sayori--!」	「サヨリ……！」	Sayori--!	「サヨリ……！」
「Just now, we weren't--」	「俺たち今――！」	Just now, we weren't--	「今の――！」
「Ehehe~」	「えへへ」	Ehehe~	「うふふ」
「It's okay, [player].」	「いいんだよ、[player]」	It's okay, [player].	「いいんだよ、[player]」
「I just stopped by to say hi~」	「ただあいさつしに来ただけだから」	I just stopped by to say hi~	「ただあいさつしに来ただけだから」
「U-Um...」	「え、えっと……」	U-Um...	「その……」
「Well, it's nice to see you...」	「その、会えて良かったです……」	Well, it's nice to see you...	「その、会えて良かったです……」
「I'm sorry, but I'm already on my way to leave!」	「でもごめんなさい、私今から帰るところなので！」	I'm sorry, but I'm already on my way to leave!	「でも、ごめんなさい、私今から帰るところなので！」
「Aw, really?」	「えーっ、そうなの？」	Aw, really?	「えーっ、そうなの？」
「That's too bad...」	「残念だなぁ……」	That's too bad...	「ざ、残念ね……」
「I'm sorry...」	「ごめんなさい……」	I'm sorry...	「そうだね……」
「But we'll all be together at the festival tomorrow, so...」	「でも明日の文化祭でみんなで会えるから……」	But we'll all be together at the festival tomorrow, so...	「でも明日の文化祭ではみんなで会えるから……」
「So that's fine, right?」	「それで良いですか？」	So that's fine, right?	「それで良いですか？」
「Of course!」	「もちろんだよ！」	Of course!	「もちろん！」
Sayori beams.	サヨリは目を輝かせる。	Sayori beams.	サヨリは目を輝かせる。
「Y-Yeah, so...」	「だ、だから、その……」	Y-Yeah, so...	「だ、だから、その……」
「I'll see you tomorrow!」	「また明日！」	I'll see you tomorrow!	「また明日！」
Clearly embarrassed, Yuri hurries off.	明らかに恥ずかしそうなユリは急いで立ち去る。	Clearly embarrassed, Yuri hurries off.	あからさまに恥ずかしげな様子でユリは足早に立ち去った。
Sayori waves goodbye after her.	サヨリは彼女に向けて手を振った。	Sayori waves goodbye after her.	サヨリは彼女に向けて手を振っている。
「Sayori--」	「サヨリ……」	Sayori--	「サヨリ……」
