I pull the first volume of Parfait Girls out from my bag.	俺はカバンから『パフェガールズ』の一巻を引っ張り出した。	I pull the first volume of Parfait Girls out from my bag.	俺はカバンから『パフェガールズ』の一巻を引っ張り出した。
Natsuki takes it from my hands, then quickly turns it over, presumably to check for wrinkles.	ナツキはそれを俺の手から取ると、すぐさまページをめくり始めた。おそらく状態を確認しているのだろう。	Natsuki takes it from my hands, then quickly turns it over, presumably to check for wrinkles.	ナツキはそれを俺の手から取ると、素早くページをめくり始めた。おそらく状態を確認しているのだろう。
「Hey, I'm not that careless...」	「おい、そこまではいい加減じゃないぞ……」	Hey, I'm not that careless...	「おい、そこまではいい加減じゃないぞ……」
「I handle manga all the time, you know.」	「俺だってマンガは扱い慣れてるんだし」	I handle manga all the time, you know.	「俺だってマンガは扱い慣れてるんだし」
「I just wanted to make sure!」	「確認したかっただけよ！」	I just wanted to make sure!	「確認したかっただけよ！」
「Can you blame me for being paranoid?」	「疑い深くて悪かったわね」	Can you blame me for being paranoid?	「疑い深くて悪かったわね」
「I don't give people my manga every day, you know.」	「人にマンガを貸すことなんてないんだから」	I don't give people my manga every day, you know.	「人にマンガを貸すことなんてないんだから」
「That's true...」	「そうだよな……」	That's true...	「そうだよな……」
「I don't blame you.」	「気にしないからいいよ」	I don't blame you.	「気にしないからいいよ」
「Well anyway, let me put this one back.」	「とりあえず、これをしまってくるわ」	Well anyway, let me put this one back.	「とりあえず、これをしまってくるわ」
「I'm gonna get the next one, okay?」	「ついでに次の巻も取ってくるわね」	I'm gonna get the next one, okay?	「ついでに次の巻も取ってくるわね」
Natsuki makes her way to the closet.	ナツキはクローゼットの方へ向かった。	Natsuki makes her way to the closet.	ナツキは物置の方へ向かった。
I follow.	俺も後をついていく。	I follow.	俺も後をついていく。
「So you're gonna tell me everything you thought, right??」	「さて、感想をしっかり聞かせてくれるのよね？」	So you're gonna tell me everything you thought, right??	「さて、感想をしっかり聞かせてくれるのよね？」
「Where did this volume leave off again? I forget.」	「どこまで話が進んだの？ 忘れちゃったわ」	Where did this volume leave off again? I forget.	「どこまで話が進んだの？ 忘れちゃったわ」
「Ah, the chapter ended when Minori and Alice found--」	「ああ、最後の話はミノリとアリスが……」	Ah, the chapter ended when Minori and Alice found--	「ああ、最後の話はミノリとアリスが……」
「<i>Monika!!</i>」	「<i>モニカ！！</i>」	<i>Monika!!</i>	「<i>モニカ！！</i>」
Natsuki's voice resonates out from inside the closet.	ナツキの声がクローゼットの中で響き渡る。	Natsuki's voice resonates out from inside the closet.	ナツキの声が物置の中に響き渡る。
「Eh...?」	「えっ……？」	Eh...?	「え……？」
I peer inside.	俺は棚の中を覗いた。	I peer inside.	俺も中をのぞいた。
All of Natsuki's books are lined up on the top shelf.	ナツキのマンガが全て棚の最上段に並べられている。	All of Natsuki's books are lined up on the top shelf.	ナツキのマンガが全て棚の最上段に並べられている。
「Did you move my manga again?!」	「またわたしのマンガを動かしたの！？」	Did you move my manga again?!	「またアタシのマンガを動かしたの！？」
「Ah, sorry, sorry!」	「あっ、ごめんごめん！」	Ah, sorry, sorry!	「あっ、ごめんごめん！」
「The teacher got mad at me for taking up so much space in her closet...」	「人の棚を占領しすぎだ、って先生に怒られちゃって……」	The teacher got mad at me for taking up so much space in her closet...	「人の棚を占領しすぎだ、って先生に怒られちゃって……」
「So I had to move some stuff around and clean up a little bit.」	「だから物を動かして片付けないといけなかったの」	So I had to move some stuff around and clean up a little bit.	「だから物を動かして片付けないといけなかったの」
「It's all still there, I just had to organize it a bit!」	「ちょっと整理しただけで、物は全部そこに入ってるから！」	It's all still there, I just had to organize it a bit!	「ちょっと整理しただけで、全部そこに入ってるから！」
「Ugh...」	「もう……」	Ugh...	「あれ……」
The top shelf is far above Natsuki's head.	棚の最上段はナツキの頭のはるか上に位置している。	The top shelf is far above Natsuki's head.	棚の最上段はナツキの頭のはるか上に位置している。
She makes a futile hop, trying to figure out how to reach her manga.	ナツキは最上段に届く方法を考えながら、無益にぴょんと跳んだ。	She makes a futile hop, trying to figure out how to reach her manga.	ナツキは最上段に届かないかと、無駄にぴょんと跳んだ。
「Jeez...!」	「まったく……！」	Jeez...!	「まったく……！」
「This is so inconvenient!」	「不便で仕方ないわ！」	This is so inconvenient!	「不便で仕方ないわ！」
「I'm moving these all back down.」	「これ、全部下に降ろすわ」	I'm moving these all back down.	「これ、全部下に降ろすわ」
「There's plenty of room on these shelves.」	「棚のスペースはまだいっぱいあるんだし」	There's plenty of room on these shelves.	「棚のスペースはまだいっぱいあるんだし」
「And besides...」	「それに……」	And besides...	「それに……」
「They're really pretty to look at when they're all lined up!」	「マンガが綺麗に並んでるのを見ると気持ちがいいんだもの！」	They're really pretty to look at when they're all lined up!	「マンガが綺麗に並んでるのを見ると気持ちがいいんだもの！」
「Why would you waste that on the top shelf?」	「それをなんで最上段にすることで無駄にしなきゃいけないのよ」	Why would you waste that on the top shelf?	「なのに最上段なんかにあったら見えないじゃない」
「Ah, Natsuki...」	「あっ、ナツキ……」	Ah, Natsuki...	「あー、ナツキ……」
「There's a stool on the wall there.」	「壁のそこにスツールがあるぞ」	There's a stool on the wall there.	「そこの壁にスツールがあるぞ」
In the closet, there's a collapsible stool that's hanging on the wall.	クローゼットの中の壁に、折りたたみ式のスツールが引っかかっている。	In the closet, there's a collapsible stool that's hanging on the wall.	物置の壁に、折りたたみ式のスツールがかかっている。
「If you want, I can reach up there and hand them to you...」	「俺がマンガを取っていってナツキに渡していこうか？」	If you want, I can reach up there and hand them to you...	「俺がマンガを取って、ナツキに渡していこうか？」
「I can get them myself!」	「自分で取れるわよ！」	I can get them myself!	「自分で取れるわよ！」
Natsuki grabs the stool from the wall and unfolds it.	ナツキは壁からスツールを取って広げた。	Natsuki grabs the stool from the wall and unfolds it.	ナツキは壁からスツールを取って広げた。
「You think I'm too short or something?」	「わたしじゃ背が低すぎるとでも思ったんでしょ？」	You think I'm too short or something?	「アタシじゃ背が低すぎるとでも思ったんでしょ？」
「I mean--」	「その――」	I mean--	「ええと……」
「I <i>knew</i> it!」	「<i>やっぱり！</i>」	I <i>knew</i> it!	「<i>やっぱり！</i>」
「Well, you know what?」	「それなら見てなさい」	Well, you know what?	「それなら見てなさい」
「Just watch me!」	「自分でできるんだから！」	Just watch me!	「自分でできるんだから！」
Natsuki hops onto the stool, which ends up being a little wobbly because of its collapsible design.	ナツキがスツールに飛び乗ると、簡易的な設計のせいか少しぐらついた。	Natsuki hops onto the stool, which ends up being a little wobbly because of its collapsible design.	ナツキがスツールに跳び乗ると、折り畳みできる設計のせいで少しぐらついた。
「A-Ah...」	「うわ、っと……」	A-Ah...	「う、うん……」
「Careful...」	「気をつけろ……」	Careful...	「気をつけろ……」
「I know what I'm doing!!」	「言われなくても分かってるわよ！！」	I know what I'm doing!!	「言われなくてもわかってるわよ！！」
Standing on the stool, Natsuki's fingertips reach the top shelf.	スツールに立つとナツキの指先が最上段に届いた。	Standing on the stool, Natsuki's fingertips reach the top shelf.	スツールに立つとナツキの指先が最上段に届いた。
The stool would be enough for me to easily grab the books, but Natsuki is being stubborn as usual.	俺がスツールに立てば簡単に手が届くが、ナツキはいつも通り意地を張ってしまっている。	The stool would be enough for me to easily grab the books, but Natsuki is being stubborn as usual.	俺がスツールに立てば簡単に手が届くだろうが、ナツキはいつも通り意地を張っている。
「U-Uuuh...」	「う、ううぅぅ……」	U-Uuuh...	「う、ううぅぅ……」
Natsuki uses her fingers to scoot one of the smaller boxes to the edge of the shelf.	ナツキは指先で小さめの箱を棚の端に寄せた。	Natsuki uses her fingers to scoot one of the smaller boxes to the edge of the shelf.	ナツキは指先で小さめの箱を棚の端に寄せた。
「See...?」	「ほらね……？」	See...?	「ほらね……？」
「Kyah--!」	「きゃっ――！」	Kyah--!	「きゃっ――！」
The box suddenly tips.	箱が突然滑り落ちる。	The box suddenly tips.	箱が突然傾く。
Natsuki barely catches it before it falls to the floor.	床に落ちる前にナツキがなんとかキャッチすることに成功した。	Natsuki barely catches it before it falls to the floor.	ナツキが箱をかろうじてキャッチしたのは、床に落ちる寸前だった。
The stool wobbles.	スツールがぐらぐら揺れる。	The stool wobbles.	スツールがぐらぐら揺れる。
「Wawaa--」	「わわっ――」	Wawaa--	「わわっ――」
Losing balance, Natsuki hops off the stool.	バランスを崩し、ナツキはスツールから飛び降りた。	Losing balance, Natsuki hops off the stool.	バランスを崩し、ナツキはスツールから跳び降りた。
Thankfully, she was able to stay on her feet.	幸い、無事に両足で着地する。	Thankfully, she was able to stay on her feet.	幸い、無事に両足で着地する。
She holds the box triumphantly.	ナツキは勝ち誇ったように箱を持ち上げた。	She holds the box triumphantly.	ナツキは勝ち誇ったように箱を持ち上げた。
「T-There!」	「ほ、ほら見なさい！」	T-There!	「ほ、ほら見なさい！」
Having almost fell, Natsuki is a bit shaken up.	落ちそうになったことで、若干動揺しているのが見える。	Having almost fell, Natsuki is a bit shaken up.	こけそうになったことで、若干動揺しているのが見える。
「Jeez...」	「まったく……」	Jeez...	「はあ……」
「No need to prove yourself to me.」	「自分を証明するようなことをしなくても良かったのに」	No need to prove yourself to me.	「自分を証明するようなことをしなくても良かったのに」
「There's no way you'll be able to get the bigger boxes like that.」	「そんな様子じゃ大きい箱は取れそうにないぞ」	There's no way you'll be able to get the bigger boxes like that.	「そんな様子じゃ大きな箱は取れそうにないぞ」
「I can reach them, so just--」	「俺なら手が届くから、代わりに――」	I can reach them, so just--	「俺なら手が届くから、代わりに――」
「I said I can do it!」	「できるって言ったでしょ！」	I said I can do it!	「できるって言ったでしょ！」
「I don't want your help, okay?」	「手伝いはいらないわ、分かった？」	I don't want your help, okay?	「手伝いはいらないわ、わかった？」
「Sigh...」	「はあ……」	Sigh...	「はあ……」
「I'm gonna get a chair, so just hang on.」	「椅子を取ってくるから待ってなさい」	I'm gonna get a chair, so just hang on.	「椅子を取ってくるから待ってなさい」
Natsuki forces her way past me out of the closet.	ナツキは俺を押しのける勢いでクローゼットから出た。	Natsuki forces her way past me out of the closet.	ナツキは俺を押しのける勢いで物置から出た。
「Let's see...」	「そうねえ……」	Let's see...	「そうですね……」
The classroom chairs have the desks attached, so they're too inconvenient to fit into the closet.	教室の椅子は机に繋がっているから、それごとクローゼットに入れるのは不便だ。	The classroom chairs have the desks attached, so they're too inconvenient to fit into the closet.	教室の椅子は机につながっているから、それごと物置に入れるには不便だ。
「Aha!」	「あっ！」	Aha!	「あっ！」
Natsuki trots over to the teacher's desk, which has a computer chair behind it.	ナツキは教師用の事務机の方まで小走りした。机の中にはオフィスチェアが入っている。	Natsuki trots over to the teacher's desk, which has a computer chair behind it.	ナツキは教師用の事務机の方まで小走りした。机の後ろにはオフィスチェアがある。
She rolls it on its wheels back over to the closet.	ナツキはチェアのキャスターを転がせてクローゼットまで移動させる。	She rolls it on its wheels back over to the closet.	ナツキはチェアのキャスターを転がして物置まで移動させる。
「Ah--」	「あー……」	Ah--	「えっと……」
It's a little dangerous, since the chair swivels and rolls.	その椅子だと回ったり動いたりするから少し危険だ。	It's a little dangerous, since the chair swivels and rolls.	その椅子だと回ったり動いたりするから少し危険だ。
But I've already learned my lesson, so I keep my mouth shut.	しかし口出しするとどうなるか学んだ俺は何も言わない。	But I've already learned my lesson, so I keep my mouth shut.	しかし口出しするとどうなるか学んだ俺は何も言わないことにした。
「Ush--」	「んしょっ――」	Ush--	「んしょっ――」
Natsuki climbs onto the chair, then slowly balances onto her feet.	ナツキは椅子に登って、ゆっくり立ってバランスを取る。	Natsuki climbs onto the chair, then slowly balances onto her feet.	ナツキは椅子に登り、ゆっくり立ってバランスを取る。
Since she refuses my help, I take a seat with my back against the side of the doorway and simply watch.	手伝おうとしても拒まれてしまうから、俺は背を扉に預けて座り込み、ただ見守る。	Since she refuses my help, I take a seat with my back against the side of the doorway and simply watch.	手伝おうとしても拒まれてしまうから、俺は背を扉に預けて座り込み、ただ見守る。
「Aha! There we go!」	「はい！ これでよし！」	Aha! There we go!	「はい！ これでよし！」
「See? I can easily do it now.」	「ほらね？ 簡単にできるようになったでしょ」	See? I can easily do it now.	「ほらね？ 簡単に取れるでしょ」
Natsuki grabs a stack of manga and bends down to put it on the shelf below.	ナツキは上段からマンガの山を取ると、下の段に置くためにかがみ込んだ。	Natsuki grabs a stack of manga and bends down to put it on the shelf below.	ナツキは上段からマンガの山を取ると、下の段に置くためにかがみ込んだ。
「W-Wahh--」	「わ、わっ――」	W-Wahh--	「わ、わっ――」
The chair swivels.	椅子が回転した。	The chair swivels.	椅子が回転した。
Natsuki catches herself on the shelf.	ナツキは本棚に掴まる。	Natsuki catches herself on the shelf.	ナツキは本棚につかまる。
「What are you doing??」	「あんた何してんの？」	What are you doing??	「アンタ何してんの？」
「Can you at least hold the chair steady instead of sitting and doing nothing?」	「座ってボーっとしてる暇があるなら椅子が揺れないように持つことくらいできるでしょ？」	Can you at least hold the chair steady instead of sitting and doing nothing?	「座ってボーっとしてる暇があるなら椅子が動かないように持つことくらいできるでしょ？」
<i>(Who was it who told me not to help...?)</i>	<i>（お前が手伝うなって言ったんじゃ……）</i>	<i>(Who was it who told me not to help...?)</i>	<i>（お前が手伝うなって言ったんじゃ……）</i>
「Yeah, yeah...I got you.」	「分かった分かった、やるよ……」	Yeah, yeah...I got you.	「わかったわかった、やるよ……」
I hold the chair while Natsuki reaches back up.	俺が椅子をおさえると、ナツキは再び上段に手を伸ばした。	I hold the chair while Natsuki reaches back up.	俺が椅子をおさえると、ナツキは再び上段に手を伸ばした。
「--!」	「――っ！」	--!	「――っ！」
I can...	見え……	I can...	これは……
<i>I can almost see up her skirt?!</i>	<i>ナツキのスカートの中が見えてしまうのでは！？</i>	<i>I can almost see up her skirt?!</i>	<i>ナツキのスカートの中が見えてしまうのでは！？</i>
「Guh--」	「くっ――」	Guh--	「くっ――」
I force myself to turn away.	俺は目を背けた。	I force myself to turn away.	俺は目を背けた。
Natsuki seriously didn't think this through...!	ナツキはこの事に気づかなかったのか……！	Natsuki seriously didn't think this through...!	ナツキはこの事に気づかなかったのか……！
Once she realizes, I'll be dead!	ナツキが気づいたら、殺される！	Once she realizes, I'll be dead!	ナツキに気づかれたら、殺される！
「Hup--」	「よいしょ――」	Hup--	「よいしょ――」
Natsuki wraps her arms around the Parfait Girls box set, easily the largest one on the shelf.	ナツキはこの棚で一番重いであろう『パフェガールズ』の箱を腕で抱え込む。	Natsuki wraps her arms around the Parfait Girls box set, easily the largest one on the shelf.	ナツキはこの棚で一番重いであろう『パフェガールズ』の箱を腕で抱え込む。
「Uu...heavy...」	「うう……重い……」	Uu...heavy...	「うう……重い……」
「Hey, [player]...」	「ちょっと、[player]……」	Hey, [player]...	「ねえ、[player]君」
「I-I don't think I can bend down without falling...!」	「か、屈むと椅子から落ちちゃう…！」	I-I don't think I can bend down without falling...!	「か、屈むと椅子から落ちちゃう…！」
「Hurry and take this one...」	「急いでこれ持って……」	Hurry and take this one...	「急いでこれ持って……」
「Eh?」	「え？」	Eh?	「えっ？」
「But then I have to let go of the chair...」	「でもそうしたら椅子が……」	But then I have to let go of the chair...	「でもそうしたら椅子が……」
「That's fine...!」	「いいから……！」	That's fine...!	「いいから……！」
「Just for a second!」	「ほんの一瞬だから！」	Just for a second!	「ほんの一瞬だから！」
「Hurry up...」	「早く……」	Hurry up...	「早く……」
「Alright...!」	「分かったよ……」	Alright...!	「わかったよ……」
「Let me just stand up.」	「今立つから……」	Let me just stand up.	「今立つから……」
I slowly release my grip from the chair.	俺はゆっくりと椅子から手を離した。	I slowly release my grip from the chair.	俺はゆっくりと椅子から手を離した。
「What do you mean 'stand up'?」	「あんた『立つ』ってどういうこと？」	What do you mean 'stand up'?	「アンタ、『立つ』ってどういうこと？」
Natsuki looks down at me.	ナツキは俺を見下ろした。	Natsuki looks down at me.	ナツキは俺を見下ろした。
「Why are you all the way back--」	「なんであんたずっと後ろにいるの――」	Why are you all the way back--	「なんでアンタずっと後ろにいるの――」
「E-Eh...?」	「えっ、え……？」	E-Eh...?	「えっ、え……？」
Natsuki looks like she just realized something, but she'll lose her balance if she moves.	ナツキは何かに気づいたようだが、今動いたらバランスを崩してしまう。	Natsuki looks like she just realized something, but she'll lose her balance if she moves.	ナツキは何かに気づいたようだが、今動いたらバランスを崩してしまう。
「Natsuki, the box--」	「ナツキ、箱を――」	Natsuki, the box--	「ナツキ、箱を――」
「<i>W-What are you looking at?!</i>」	「<i>な…何見てんのよ！？</i>」	<i>W-What are you looking at?!</i>	「<i>な…何見てんのよ！？</i>」
「--!」	「――っ！」	--!	「っ！」
「You're trying to look at my...m-my...」	「あんた覗こうと……ス、スカートを……」	You're trying to look at my...m-my...	「アンタ、ス、スカートの中をのぞこうと…………」
Natsuki's legs shake.	ナツキの脚が震える。	Natsuki's legs shake.	ナツキの脚が震える。
「I-I'm not! I was just--」	「ち、違う！ 俺はただ――」	I-I'm not! I was just--	「ち、違う！ 俺はただ――」
「--Natsuki, don't try to move!」	「――ナツキ！ 今動いちゃダメだ！」	--Natsuki, don't try to move!	「――ナツキ！ 今動いちゃダメだ！」
「Just give me the box!」	「早く俺に箱を渡すんだ！」	Just give me the box!	「早くその箱を渡すんだ！」
「You...you perv!」	「こ……この変態！」	You...you perv!	「こ……この変態！」
「You set me up!!」	「わたしをハメたわね！」	You set me up!!	「アタシをハメたわね！」
「Go away!」	「出ていって！」	Go away!	「出ていって！」
「Get out!」	「出て行け！！」	Get out!	「出て行け！！」
「But--」	「で、でも――」	But--	「でもさ――」
「I'll do it myself!!」	「あとは自分でやる！！」	I'll do it myself!!	「あとは自分でやる！！」
「A-Ah--」	「あっ、ああっ！」	A-Ah--	「あ、あっ……」
The chair suddenly swivels beneath Natsuki's feet.	突然、ナツキの足で椅子が回転した。	The chair suddenly swivels beneath Natsuki's feet.	突然、ナツキの足元で椅子が回転した。
「Natsuki--!」	「ナツキ――」	Natsuki--!	「ナツキ――」
「<i>Kyaaaaa!</i>」	「<i>きゃああああ！！</i>」	<i>Kyaaaaa!</i>	「<i>きゃああああ！！</i>」
The scene turns to chaos in a split second.	状況は一瞬にして混沌となった。	The scene turns to chaos in a split second.	状況は一瞬にしてカオスとなった。
The chair flies from under Natsuki's feet.	椅子がナツキの足の下から離れる。	The chair flies from under Natsuki's feet.	椅子がナツキの足の下から離れる。
Frantically, I try to catch her.	必死に俺は彼女を受け止めようとした。	Frantically, I try to catch her.	俺は必死になって彼女を受け止めようとした。
The box topples out of her hands, and the books go flying.	箱が彼女の手から離れ、本が宙を舞う。	The box topples out of her hands, and the books go flying.	箱が彼女の手から離れ、本が宙を舞う。
「I got you--」	「よしっ！ 受け止め――」	I got you--	「よしっ！ 受け止め――」
<i>Crash!</i>	<i>どんがらがっしゃーん！</i>	<i>Crash!</i>	<i>どんがらがっしゃーん！</i>
The full force of Natsuki's body against me throws me to the ground.	ナツキを受け止めた衝撃で俺は床に叩きつけられた。	The full force of Natsuki's body against me throws me to the ground.	ナツキを受け止めた衝撃で俺は床に叩きつけられた。
A whole bunch of books pelt me in the face.	俺の顔の上に本が大量に落ちる。	A whole bunch of books pelt me in the face.	顔の上に大量の本が降ってくる。
Natsuki tries to shield herself with her own arms as her face lands straight on my chest.	そして腕で自分を庇おうとしていたナツキの顔が俺の胸に飛び込んできた。	Natsuki tries to shield herself with her own arms as her face lands straight on my chest.	ナツキは腕で体を庇おうとしながら、顔を下にして俺の胸に飛び込んできた。
「Ungh...」	「うぐっ……」	Ungh...	「うぐっ……」
My right arm and my back seriously felt the impact.	俺の右腕と背中に尋常でない衝撃を感じた。	My right arm and my back seriously felt the impact.	右腕と背中に尋常でない衝撃が走る。
「U-Uu...」	「う――うう……」	U-Uu...	「う――うう……」
Slowly, Natsuki comes to her senses.	ゆっくりとナツキは我に返る。	Slowly, Natsuki comes to her senses.	ゆっくりとナツキが我に返る。
「Ghk--!」	「ぐっ――！」	Ghk--!	「ぐっ――！」
She presses her arms straight into me to prop herself up.	ナツキは身体を起こすためにまっすぐ腕を俺に押し付けた。	She presses her arms straight into me to prop herself up.	身体を起こそうとしたナツキが、腕をまっすぐ俺に押し付けた。
「Eh...?」	「え……？」	Eh...?	「え……？」
Natsuki seems to realize that it's not the floor that's beneath her.	ナツキは身体の下が床ではないことに気づいたようだ。	Natsuki seems to realize that it's not the floor that's beneath her.	そこで身体の下にあるのが床ではないことに気づいたようだ。
「G-Guuuuu...!!」	「う、うぅぅぅ……！」	G-Guuuuu...!!	「う、うぅぅぅ……！」
「Gross! Gross!」	「キモい！ キモい！！」	Gross! Gross!	「キモい！ キモい！！」
「Ghak--!」	「ぐはっ――！」	Ghak--!	「ぐはっ――！」
A fist pounds into my chest.	ナツキの拳が俺の胸に命中する。	A fist pounds into my chest.	ナツキの拳が俺の胸に命中する。
Natsuki then hoists herself to her feet.	それからナツキは、自力で立ち上がった。	Natsuki then hoists herself to her feet.	それからナツキは、自力で立ち上がった。
「What were you thinking?!」	「本っ当に何考えてるの？！」	What were you thinking?!	「本っ当に何考えてるの？！」
「You sicko!」	「この変態！」	You sicko!	「この変態！」
「Everything okay over there...?」	「みんな……大丈夫……？」	Everything okay over there...?	「みんな……大丈夫……？」
「I heard a loud noise...」	「大きな音が聞こえたんだけど……」	I heard a loud noise...	「大きな音が聞こえたんだけど……」
Monika suddenly peers in.	モニカが突然入ってきた。	Monika suddenly peers in.	モニカが突然入ってきた。
「Monika!」	「モニカ！」	Monika!	「モニカちゃんって言うんだ！」
「See what happens when you put the manga on the top shelf?!」	「マンガを棚の一番上に置こうとか何考えてるの！？」	See what happens when you put the manga on the top shelf?!	「マンガを一番上の棚に置くなんて、何考えてるの！？」
「Are you trying to kill your club members or something?」	「部員を殺そうとでもしてんの？」	Are you trying to kill your club members or something?	「部員を殺そうとでもしてんの？」
「Jeez!」	「もー！」	Jeez!	「もー！」
「S-Sorry, sorry!」	「ご、ごめんごめん！」	S-Sorry, sorry!	「ご、ごめんごめん！」
「Ahaha...」	「あはは……」	Ahaha...	「そうだな……」
「Oh, and one more thing.」	「あっ、あともう一つ」	Oh, and one more thing.	「あっ、あともう一つ」
「It seems like your most recent club member is a total pervert.」	「あんたが入れた新入部員は全くの変態だったみたいね」	It seems like your most recent club member is a total pervert.	「アンタが入れた新入部員、完全な変態だったみたいね」
「So I hope you're happy.」	「良かったわね」	So I hope you're happy.	「良かったわね」
「I didn't--!」	「そ、そんな――」	I didn't--!	「そ、そんな――」
Somehow, it's impossible for me to explain this whole bizarre situation to Monika.	俺がこの状況の端緒をモニカに説明するのは不可能のようだ。	Somehow, it's impossible for me to explain this whole bizarre situation to Monika.	俺がこのおかしな状況をすべてモニカに説明するのは不可能のようだ。
「I didn't do anything, I swear...!」	「俺は何もしてない！ そう誓う！！」	I didn't do anything, I swear...!	「俺は何もしてない！ 誓ってもいい！！」
「I know, I know, don't worry~」	「分かってる、分かってる、心配しないで～」	I know, I know, don't worry~	「わかってる、わかってる、心配しないで～」
Monika says that quietly to me.	モニカは静かに俺にそう言った。	Monika says that quietly to me.	モニカは静かに俺にそう言った。
Looks like I'm off the hook...	俺は難を逃れたように思えた……	Looks like I'm off the hook...	難を逃れただろうか……
「Oh no...!」	「あっ！」	Oh no...!	「あっ！」
「My...my...」	「わたしの……わたしの……」	My...my...	「アタシの……アタシの……」
「Eh?」	「え？」	Eh?	「はっ？」
I look down.	俺は視線を落とす。	I look down.	俺は視線を落とす。
Natsuki is kneeling on the floor, holding one of the books that are scattered all over.	ナツキは床にしゃがみ込んで、散らばった本の中から一冊を掴み上げた。	Natsuki is kneeling on the floor, holding one of the books that are scattered all over.	ナツキは床にしゃがみ込んで、散らばった本の中から一冊を手に取った。
There's a large diagonal crease along the page that she's desperately trying to smooth out.	彼女はその本に付いた大きな折り目を伸ばそうと必死になっていた。	There's a large diagonal crease along the page that she's desperately trying to smooth out.	その本に付いた大きな折り目を伸ばそうと必死になっている。
「Ah, it must have landed on the page...」	「ああ、開いたまま落ちてしまったんだな……」	Ah, it must have landed on the page...	「ああ、開いたまま落ちちゃったんだな……」
Natsuki tries a bit more to fix the crease, but she can't get it out.	ナツキはもう少し折り目を伸ばそうと頑張るものの、折り目は直らない。	Natsuki tries a bit more to fix the crease, but she can't get it out.	ナツキは折り目を伸ばそうとがんばるものの、折り目は直らない。
Suddenly, she gives up and slams the book shut, then throws it to the floor.	突然、本を勢いよく閉じ、そしてそれを床に放り投げた。	Suddenly, she gives up and slams the book shut, then throws it to the floor.	突然、本を勢いよく閉じ、そしてそれを床に放り投げた。
Instead of continuing to yell, she just lowers her head.	彼女は泣き叫ぶどころか、ただ頭を垂れるだけだった。	Instead of continuing to yell, she just lowers her head.	さきほどまでの威勢はなく、ただ頭を垂れている。
「<i>*Sob*</i>」	「<i>ぐすっ……</i>」	<i>*Sob*</i>	「<i>ぐすっ……</i>」
「...Natsuki, are you--」	「ナツキ、大丈夫――」	...Natsuki, are you--	「ナツキ、大丈夫――」
「No!」	「うるさい！」	No!	「えっ！？」
Natsuki's voice squeaks.	ナツキは叫ぶ。	Natsuki's voice squeaks.	ナツキの声がキンと響く。
I see tears on her face.	顔には涙が見える。	I see tears on her face.	顔には涙が伝っていた。
「Ah...」	「あ……」	Ah...	「あのね……」
「I'll help get the crease out, okay?」	「折り目を伸ばすの手伝うから、な？」	I'll help get the crease out, okay?	「折り目を伸ばすの手伝うから、な？」
「It's partially my fault, so...」	「俺のせいみたいなものだし、だから……」	It's partially my fault, so...	「俺のせいでもあるし、だから……」
Natsuki shakes her head, still looking down.	ナツキは俯いたまま、首を横に振る。	Natsuki shakes her head, still looking down.	ナツキは俯いたまま、首を横に振る。
「No...」	「違う……」	No...	「いいえ……」
「I don't even care that much...」	「そんなことはいいの……」	I don't even care that much...	「そんなことはいいの……」
「I'm just...」	「ただ……」	I'm just...	「ただ……」
「Having a really bad day today...」	「今日は……本当にツイてなくて……」	Having a really bad day today...	「今日は……本当にツイてなくて……」
Natsuki sobs again.	ナツキはまた泣き始めた。	Natsuki sobs again.	ナツキはまた泣き始めた。
「I didn't mean to take it out on you...」	「あんたに当たるつもりはなかった……」	I didn't mean to take it out on you...	「アンタに当たるつもりはなかった……」
「I really didn't mean to!」	「本当にそのつもりはなかったの！」	I really didn't mean to!	「本当にそのつもりはなかったの！」
「It's...it's fine.」	「だ……大丈夫だから」	It's...it's fine.	「だ……大丈夫だから」
「...Is there anything you want to talk about?」	「……よかったら話してみないか？」	...Is there anything you want to talk about?	「……よかったら話してみないか？」
Natsuki shakes her head.	ナツキは肩を震わせる。	Natsuki shakes her head.	ナツキは頭を横に振る。
「Just...」	「ただ……」	Just...	「だって……」
「Every day...」	「毎日……」	Every day...	「毎日……」
「...is...so hard.」	「……つらくて」	...is...so hard.	「……つらくて」
「I just want to...」	「わたしはただ……」	I just want to...	「アタシはただ……」
「...come to the club and...」	「……部活に来て……っ」	...come to the club and...	「……部活に来て……っ」
「...」	「……」	...	「……」
Natsuki falls silent again.	ナツキはまた黙ってしまった。	Natsuki falls silent again.	ナツキはまた黙ってしまった。
I can't press her, so I can only do what I know how to do.	無理強いはできないから、あとは俺ができることをやるしかない。	I can't press her, so I can only do what I know how to do.	無理強いはできないから、あとは俺ができることをやるしかない。
「Alright...」	「分かった……」	Alright...	「わかった……」
「Well, I'll help clean this up.」	「じゃあ、これ片付けるの手伝うよ」	Well, I'll help clean this up.	「じゃあ、これ片付けるの手伝うよ」
「And I'll move the rest of your manga for you.」	「残りのマンガも移動させておくから」	And I'll move the rest of your manga for you.	「残りのマンガも移動させておくから」
「Ah.」	「あっ」	Ah.	「あっ」
I pick up volume 2 of Parfait Girls.	俺は『パフェガールズ』の２巻を拾った。	I pick up volume 2 of Parfait Girls.	俺は『パフェガールズ』の２巻を拾った。
「We'll set this one aside.」	「これは置いとこうな」	We'll set this one aside.	「これは置いとこうな」
「This'll help cheer you up a bit, right?」	「これを読めば少しは元気になれるんじゃないか？」	This'll help cheer you up a bit, right?	「これを読めば少しは元気になれるんじゃないか？」
「We can get started on it once I'm done here.」	「片付けが終わったら読もうな」	We can get started on it once I'm done here.	「片付けが終わったら読もうな」
Natsuki looks up with her glossy eyes.	ナツキは潤んだ目で見上げてきた。	Natsuki looks up with her glossy eyes.	ナツキが潤んだ目でこちらを見上げる。
Her lip quivers.	唇が震える。	Her lip quivers.	唇を震わせている。
「You're...」	「あんた……」	You're...	「もしかして……」
「You're really nice to me...」	「優しいのね……」	You're really nice to me...	「優しいのね……」
「Eh?」	「えっ？」	Eh?	「ええっ？」
That sounds really strange, coming from Natsuki.	ナツキがそんな事を言うと非常に奇妙に聞こえる。	That sounds really strange, coming from Natsuki.	ナツキがそんな事を言うと非常に奇妙に聞こえる。
I didn't expect it at all.	全くの予想外だ。	I didn't expect it at all.	まったくの予想外だ。
「Well...」	「まあ……」	Well...	「今度は……」
「I'm just treating you like a friend, you know?」	「友達ってこういうことだろ、な？」	I'm just treating you like a friend, you know?	「友達ってこういうことだろ、な？」
「Nn...」	「ん……」	Nn...	「ん……」
Natsuki lowers her head and stifles another sob.	ナツキはうつむいて泣くのを堪えた。	Natsuki lowers her head and stifles another sob.	ナツキは俯いて泣くのを堪えた。
I'm not sure what happened to her today, but being nice is the least I could do.	今日、彼女に何があったのかは分からないが、俺ができる事はただ優しく接することだ。	I'm not sure what happened to her today, but being nice is the least I could do.	今日、彼女に何があったのかはわからないが、俺にできるのはただ優しく接することだけだ。
The next couple minutes are silent between us as I begin gathering the scattered books.	俺が散らばったマンガを片付ける間、お互いに無言だった。	The next couple minutes are silent between us as I begin gathering the scattered books.	俺が散らばったマンガを片付け始めてしばらくは、どちらも無言だった。
I make sure to slip them into the box in their correct order.	ちゃんと順番通りになっているか確認しながら、俺は本を箱にしまっていく。	I make sure to slip them into the box in their correct order.	ちゃんと順番通りになっているか確認しながら、本を箱にしまっていく。
After a little bit, Natsuki starts helping.	しばらくしてからナツキが手伝い始めた。	After a little bit, Natsuki starts helping.	しばらくすると、ナツキも手伝い始めた。
It isn't long before we're done, and I hoist the box onto the shelf where Natsuki wanted to put it.	マンガをしまい終わるまでそう時間はかからず、最後に俺はナツキの希望通りの場所に箱を置いた。	It isn't long before we're done, and I hoist the box onto the shelf where Natsuki wanted to put it.	マンガをしまい終わるまでそう時間はかからず、最後に俺はナツキの希望通りの場所に箱を置いた。
Then, I get on the stool and quickly finish moving the rest of her books from the top shelf.	そして、俺はスツールに乗って残りのマンガも最上段から全部下に移動させた。	Then, I get on the stool and quickly finish moving the rest of her books from the top shelf.	そして、俺はスツールに乗って残りのマンガも最上段から全部下に移動させた。
「Alright--!」	「よし！」	Alright--!	「よし！」
「That should do it.」	「こんなもんだな」	That should do it.	「こんなもんだな」
I hop off the stool.	俺はスツールから降りた。	I hop off the stool.	俺はスツールから降りた。
Natsuki averts her gaze.	ナツキは目をそらす。	Natsuki averts her gaze.	ナツキが目をそらす。
「T-Thanks...」	「あ、ありがとう……」	T-Thanks...	「あ、ありがとう……」
「Ahaha...」	「ははっ……」	Ahaha...	「あはは……」
「It's nothing.」	「大したことじゃねえよ」	It's nothing.	「大したことじゃねえよ」
Natsuki is holding the volume I set aside in her hands.	ナツキは俺が置いてたマンガを手に持っている。	Natsuki is holding the volume I set aside in her hands.	ナツキは俺が置いてたマンガを手に持っている。
「Alright, I'm ready.」	「よし、読む用意はできたぞ」	Alright, I'm ready.	「よし、読む用意はできたぞ」
「Good.」	「分かったわ」	Good.	「わかったわ」
「Even if you weren't, I'd make you anyway.」	「できてなくても強制的に読ませてたけど」	Even if you weren't, I'd make you anyway.	「できてなくても強制的に読ませてたけど」
「You're taking responsibility for what you said.」	「自分の発言に責任を取ってよね」	You're taking responsibility for what you said.	「自分の発言に責任を取ってよね」
「The thing about cheering me up.」	「わたしを元気づけるってやつ」	The thing about cheering me up.	「わたしを元気づけるってやつ」
「If you insist!」	「そう言うのなら！」	If you insist!	「お前がそう言うのなら！」
We sit in the same spot as last time, and I open the second volume.	二人で前回と同じ場所に座り込み、俺は２巻を開いた。	We sit in the same spot as last time, and I open the second volume.	二人で前回と同じ場所に座り込み、俺は２巻を開いた。
Natsuki's mood quickly improves, laughing and pointing things out to me.	ナツキの機嫌はすぐに回復し、笑ったりマンガの内容を指摘したりしだした。	Natsuki's mood quickly improves, laughing and pointing things out to me.	ナツキの機嫌はすぐに回復し、笑ったりマンガの内容を指摘したりしだした。
She's surprisingly sharp, making note of a lot of subtle repeated jokes and background elements.	彼女は驚くほど鋭かった。捉えにくい繰り返されるジョークや背景の要素など、覚えておくべき箇所を教えてくれた。	She's surprisingly sharp, making note of a lot of subtle repeated jokes and background elements.	彼女は驚くほど鋭かった。繰り返される難解なジョークや背景の要素など注釈を入れてくれる。
In the end, I'm pretty impressed by how everything ties together in this manga.	最終的に、このマンガの全ての要素が繋がっていることに、俺はかなり感心した。	In the end, I'm pretty impressed by how everything ties together in this manga.	最終的に、このマンガのすべての要素がつながっていることに、俺はかなり感心した。
I guess Natsuki has good taste after all.	ナツキはいいマンガの趣味をしていたようだ。	I guess Natsuki has good taste after all.	ナツキはいいマンガの趣味をしていたようだ。
After some time, Monika gets our attention as usual, and it's time to share poems again.	しばらく経つと、いつも通りモニカが俺たちに呼びかけ、詩を見せ合う時間になったことを合図してきた。	After some time, Monika gets our attention as usual, and it's time to share poems again.	しばらく経つと、いつも通りモニカが俺たちに呼びかけ、詩を見せ合う時間になったことを知らせてくれた。
「Guess I'll be holding onto this for now.」	「それじゃ、これは俺が預かっておくな」	Guess I'll be holding onto this for now.	「それじゃ、これは俺が預かっておくな」
「Yep!」	「そうね！」	Yep!	「そうね！」
「Even you sound more enthusiastic this time.」	「前回よりは乗り気みたいじゃない」	Even you sound more enthusiastic this time.	「前回よりは乗り気みたいじゃない」
「Well, I'm starting to get into it, you know.」	「まあ、だんだんハマってきたしな」	Well, I'm starting to get into it, you know.	「まあ、だんだんハマってきたしな」
「Ehehe.」	「えへへっ」	Ehehe.	「えへへ」
「Told you.」	「わたしの言った通りね」	Told you.	「アタシの言った通りね」
「Yeah, yeah...」	「はい、はい……」	Yeah, yeah...	「はいはい……」
I return to my seat and slip the book into my bag.	俺は自分の席に戻り、カバンの中にマンガをしまった。	I return to my seat and slip the book into my bag.	俺は自分の席に戻り、カバンの中にマンガをしまった。
