「[gtext]」	「[gtext]」	[gtext]	[gtext]
「Um...」	「えっと……」	Um...	「その……」
「Wait...」	「あら……」	Wait...	「あれっ……」
「How did I...」	「私どうして……」	How did I...	「私、どうして……」
「...Sorry, I just had a really weird deja vu...」	「……すみません、なんだかデジャブが……」	...Sorry, I just had a really weird déjà vu...	「……すみません、何だかおかしなデジャブが……」
「This hasn't happened before or anything...right?」	「以前にも同じことが起きたこと……ありませんよね？」	This hasn't happened before or anything...right?	「以前にも同じようなことが……起きてませんよね？」
「My head has been a little fuzzy lately...」	「最近頭がしゃんとしなくて……」	My head has been a little fuzzy lately...	「最近頭がシャンとしなくて……」
「I hope it hasn't really been showing or anything!」	「それが表に出てたりしませんでしたよね！？」	I hope it hasn't really been showing or anything!	「それが表に出てたりしないといいんですが！」
「I would hate for you to think I'm weird just after we started spending time together...」	「せっかく一緒に過ごすようになってきたのに変だと思われては嫌ですから……」	I would hate for you to think I'm weird just after we started spending time together...	「せっかく一緒に過ごすようになってきたのに、変な奴だと思われては嫌ですから……」
「I mean...」	「とはいえ……」	I mean...	「ここが……」
「Everyone has a few unusual things about them.」	「誰でも変なところなんてありますよね」	Everyone has a few unusual things about them.	「誰にでも普通じゃない部分の一つや二つ、ありますよね」
「But expressing those things so soon after meeting someone is usually seen as inappropriate...or unlikable.」	「でも誰かと知り合ってからすぐに自分のそういった部分をさらけ出すのは不適切というか……嫌われやすいようです」	But expressing those things so soon after meeting someone is usually seen as inappropriate...or unlikable.	「でも誰かと知り合ってからすぐに自分のそういった部分をさらけ出すのは、通常不適切というか……嫌われやすいようです」
「At least, that's what I've discovered.」	「少なくとも私はそう学びました」	At least, that's what I've discovered.	「少なくとも私はそう学びました」
「When I was a bit younger, I think I would come on really strongly and get a little too intense...」	「子供の頃は気づかないうちに過激に言い過ぎることがあったせいか……」	When I was a bit younger, I think I would come on really strongly and get a little too intense...	「もっと幼かった頃は、強く出すぎたり、過激に言い過ぎたりすることがあったせいか……」
「It made people not want to be around me.」	「周りから誰もいなくなってしまって」	It made people not want to be around me.	「周りから誰もいなくなってしまって」
「So...I started hating those things about myself.」	「その時から……自分のそういったところが嫌いになりました」	So...I started hating those things about myself.	「その時から……自分のそういったところが嫌いになりました」
「My obsession with certain hobbies.」	「自分の趣味の一部と……」	My obsession with certain hobbies.	「自分の、特定の趣味に熱中するところや……」
「And the way I can't control myself when I get too excited about something.」	「あまりに興奮すると自分が抑えられなくところが」	And the way I can't control myself when I get too excited about something.	「あまりに興奮しすぎると自分が抑えられなくなるところが」
「So...」	「だから……」	So...	「それで……」
「I eventually stopped trying to talk to people.」	「次第に人と関わるのをやめました」	I eventually stopped trying to talk to people.	「私は最終的に人と関わるのをやめました」
「If nobody could ever like me for the things that matter most to me...」	「私の大切なものが周りに受け入れられず、それが原因で嫌われるくらいなら……」	If nobody could ever like me for the things that matter most to me...	「私の大切なものが周りに受け入れられず、それが原因で嫌われるくらいなら……」
「...Then it's just easier if I close myself off.」	「……ふさぎ込んだほうがましですから」	...Then it's just easier if I close myself off.	「……自分の殻に閉じこもった方がマシですから」
「But recently, something's been wrong.」	「でも、最近何かおかしいんです」	But recently, something's been wrong.	「でも、最近何かおかしいんです」
「I don't know what it is.」	「何故だかわかりませんが……」	I don't know what it is.	「何がおかしいのかはわかりませんが」
「But every time we come to the club, my heart starts to go crazy.」	「部活でみんなで集まると、心臓がおかしくなるんです」	But every time we come to the club, my heart starts to go crazy.	「部活でみんなで集まるたびに、心臓がおかしくなるんです」
「Like it's going to rip out of my chest.」	「胸から飛び出るのではないかと思うほどに……」	Like it's going to rip out of my chest.	「胸から飛び出るのではないかと思うほどに」
「It overwhelms me with energy and emotions that I can't let out.」	「解放しきれないほどのエネルギーや感情に圧倒されそうになるんです」	It overwhelms me with energy and emotions that I can't let out.	「解放しきれないほどのエネルギーや感情に圧倒されるんです」
「It's been making me do weird things.」	「そのせいで変な行動に出るようになってしまって」	It's been making me do weird things.	「そのせいで変な行動に出るようになってしまって」
「I don't know why it's happening!」	「どうしてそうなるのか分からないんです！」	I don't know why it's happening!	「どうしてそうなるのか、わからないんです！」
「[player]...」	「[player]さん……」	[player]...	「[player]……」
「Is it just me, or has Monika been acting a little off lately?」	「最近、モニカちゃんの様子がおかしいのは私の気のせいでしょうか？」	Is it just me, or has Monika been acting a little off lately?	「最近、モニカちゃんの様子がおかしいのは私の気のせいでしょうか？」
「She's always been a sweetheart ever since I joined the club...」	「私が入部した時から、ずっと優しい方だったのに……」	She's always been a sweetheart ever since I joined the club...	「私が入部した時から、ずっと優しい方だったのに……」
「But recently, I've been feeling something sharp whenever she's around.」	「最近、彼女がいると何か鋭いものを感じるんです」	But recently, I've been feeling something sharp whenever she's around.	「でも最近、彼女がいると何かトゲトゲしいものを感じるんです」
「I'm not crazy, right?」	「私がおかしい訳ではありませんよね？」	I'm not crazy, right?	「私がおかしいわけではありませんよね？」
「Please tell me I'm not!」	「違いますよね！？」	Please tell me I'm not!	「違いますよね！？」
「I couldn't say anything before, because she's always listening!」	「いつもモニカちゃんに聞かれてたので、今までは何も言えなかったんです！」	I couldn't say anything before, because she's always listening!	「いつもモニカちゃんに聞かれていたので、今までは何も言えなかったんです！」
「But finally, we're alone...」	「でもようやく二人になれたので……」	But finally, we're alone...	「でもようやく二人になれたので……」
「Can we just stay here for a while?」	「しばらくここに居ましょう？」	Can we just stay here for a while?	「しばらくここにいませんか？」
「Yeah...」	「そう……」	Yeah...	よし……
「...」	「……」	...	「……」
「I just want to stay here.」	「ずっとここに居たいです」	I just want to stay here.	「ずっとここにいたいです」
「Just the two of us.」	「二人きりで」	Just the two of us.	「私たち二人きりで」,Must
「We can stay here until the club ends.」	「部活が終わるまでここに居ましょう」	We can stay here until the club ends.	「部活が終わるまで、ここにいましょう」
「And then we'll have the clubroom all to ourselves.」	「そしたら部室は私たちのものです」	And then we'll have the clubroom all to ourselves.	「そしたら部室は私たちのものです」
「Nobody to interfere with our reading time.」	「二人の読書を邪魔する者もいません」	Nobody to interfere with our reading time.	「二人の読書を邪魔する者もいません」
「Nobody to make me feel like stabbing myself in the throat.」	「自分の喉元を刺したい気分にさせる者も来ません」	Nobody to make me feel like stabbing myself in the throat.	「自分の喉元を突き刺したい気分にさせる人も来ません」
「Ahaha...」	「あはは……」	Ahaha...	「そうだな……」
「That was a joke!」	「冗談ですよ！」	That was a joke!	「冗談ですよ！」
「Just a joke.」	「ただの冗談」	Just a joke.	「ただの冗談」
「I do like knives, though...」	「でもナイフは好きです……」	I do like knives, though...	「でもナイフは好きです……」
「It sounds strange, but you wouldn't understand if you've never seen how beautiful they can be.」	「変な風に聞こえるかもしれませんが、実際にその美しさを見ればきっと分かっていただけます」	It sounds strange, but you wouldn't understand if you've never seen how beautiful they can be.	「変な風に聞こえるかもしれませんが、実際にその美しさを見ればきっとわかっていただけます」
「I have an idea.」	「そうです！」	I have an idea.	「そうだ！」
「Why don't you come to my house sometime?」	「私の家に来ませんか？」	Why don't you come to my house sometime?	「いつか、私の家に来ませんか？」
「I can show you my collection.」	「コレクションをお見せします」	I can show you my collection.	「そしたらコレクションをお見せできます」
「I've gotten them all from various artisans.」	「様々な職人から買い集めたものなんです」	I've gotten them all from various artisans.	「どれも、様々な職人から買い集めたものなんです」
「I make sure to give them all their fair share of use.」	「一つずつちゃんと使っているのですよ？」	I make sure to give them all their fair share of use.	「一つずつちゃんと使っているのですよ？」
「I don't want them to get lonely or anything...」	「寂しがらせるといけないと思って」	I don't want them to get lonely or anything...	「寂しがらせるといけないと思って……」
「Nobody deserves to be lonely.」	「誰も寂しさを味わうべきではありませんから」	Nobody deserves to be lonely.	「寂しさを味わうべき人なんて誰一人いませんから」
「Nobody.」	「誰も」	Nobody.	「誰一人」
「And that's why I'm so happy you joined the Literature Club, [player].」	「だから文芸部に入ってくださって本当に嬉しかったです、[player]さん」	And that's why I'm so happy you joined the Literature Club, [player].	「だからあなたが文芸部に入ってくださって、本当にうれしかったです、[player]さん」
「Now we don't need to be lonely anymore.」	「これで私たちも寂しくありません」	Now we don't need to be lonely anymore.	「これで私たちはもう寂しくありません」
「Because we have each other.」	「お互いが居ますもの」	Because we have each other.	「お互いがいますもの」
「Every day.」	「毎日」	Every day.	「毎日ね」
「That's all we need.」	「それだけで十分です」	That's all we need.	「それだけで十分です」
「You know what?」	「そうです！」	You know what?	「何よ、まったく！」
「Let's quit the Literature Club.」	「文芸部なんて辞めてやりましょう」	Let's quit the Literature Club.	「文芸部なんて辞めてやりましょう」
「There's no need for us to be around Monika's slimy tongue anymore.」	「これ以上モニカちゃんの下品なお喋りに付き合う必要もありませんし」	There's no need for us to be around Monika's slimy tongue anymore.	「これ以上モニカちゃんの下品なおしゃべりに付き合う必要もありませんし」
「Not to mention that other pathetic child.」	「もう一人のクソガキにも」	Not to mention that other pathetic child.	「もう一人のクソガキについては言うまでもありません」
「We can walk home together every day after school.」	「毎日一緒に下校しましょう」	We can walk home together every day after school.	「毎日一緒に下校しましょう」
「And read together.」	「そして一緒に読書をして」	And read together.	「そして一緒に読書をして」
「Eat together.」	「一緒に食べて」	Eat together.	「一緒に食べて」
「Sleep together.」	「一緒に寝る」	Sleep together.	「一緒に寝る」
「Doesn't that sound perfect?」	「素敵だと思いませんか？」	Doesn't that sound perfect?	「これで完璧でしょう？」
「It's everything we could ever want.」	「それ以上何がいると言うのです？」	It's everything we could ever want.	「それ以上何が必要だって言うんです？」
「Isn't that why you joined the club in the first place?」	「それを望んで入部したのでしょう？」	Isn't that why you joined the club in the first place?	「それを望んで入部したのでしょう？」
「It's almost like it was fate.」	「まるで運命ですね」	It's almost like it was fate.	「まるで運命ですね」
「Fate that we would meet each other.」	「二人が出会うのは運命だったのです」	Fate that we would meet each other.	「二人が出会うのは運命だったのです」
「And now we get the happy ending that I've patiently waited years for.」	「何年も待ち焦がれたハッピーエンドをようやく迎えられます」	And now we get the happy ending that I've patiently waited years for.	「これで、何年も待ち焦がれたハッピーエンドをようやく迎えられます」
「Will you do that with me, [player]?」	「私とそうしてくれますよね、[player]さん？」	Will you do that with me, [player]?	「私とそうしてくれますよね、[player]さん？」
「Will   [gtext]」	「私と                                                            [gtext]」	Will   [gtext]	私と                                                            [gtext]
